Names_mpio,Names_depto,URL_mpio,URL_depto, Mesas instaladas,Mesas informadas,Potencial sufragantes,Total sufragantes,Votos por candidatos,Votos en blanco,Votos válidos,Votos nulos,Votos no marcados,Votos_Santos,Porc_Votos_Santos,Votos_Zuluaga,Porc_Votos_Zuluaga
EL ENCANTO,AMAZONAS,http://www3.registraduria.gov.co/elecciones/elecciones2014/presidente/2v/99PR2/DPR6001099_L1.htm,http://www3.registraduria.gov.co/elecciones/elecciones2014/presidente/2v/99PR2/DPR6099999_L1.htm,2,2,746,249,230,2,232,15,2,110,47.41,120,51.72
LA CHORRERA,AMAZONAS,http://www3.registraduria.gov.co/elecciones/elecciones2014/presidente/2v/99PR2/DPR6001399_L1.htm,http://www3.registraduria.gov.co/elecciones/elecciones2014/presidente/2v/99PR2/DPR6099999_L1.htm,3,3,1038,493,484,0,484,6,3,337,69.62,147,30.37
LA PEDRERA,AMAZONAS,http://www3.registraduria.gov.co/elecciones/elecciones2014/presidente/2v/99PR2/DPR6001699_L1.htm,http://www3.registraduria.gov.co/elecciones/elecciones2014/presidente/2v/99PR2/DPR6099999_L1.htm,3,3,1042,187,179,3,182,4,1,116,63.73,63,34.61
LA VICTORIA,AMAZONAS,http://www3.registraduria.gov.co/elecciones/elecciones2014/presidente/2v/99PR2/DPR6001799_L1.htm,http://www3.registraduria.gov.co/elecciones/elecciones2014/presidente/2v/99PR2/DPR6099999_L1.htm,1,1,23,6,5,1,6,0,0,2,33.33,3,50.00
LETICIA,AMAZONAS,http://www3.registraduria.gov.co/elecciones/elecciones2014/presidente/2v/99PR2/DPR6000199_L1.htm,http://www3.registraduria.gov.co/elecciones/elecciones2014/presidente/2v/99PR2/DPR6099999_L1.htm,83,83,31335,12662,12000,384,12384,216,62,4893,39.51,7107,57.38
MIRITI PARANA,AMAZONAS,http://www3.registraduria.gov.co/elecciones/elecciones2014/presidente/2v/99PR2/DPR6001999_L1.htm,http://www3.registraduria.gov.co/elecciones/elecciones2014/presidente/2v/99PR2/DPR6099999_L1.htm,2,2,459,75,72,2,74,1,0,63,85.13,9,12.16
PUERTO ALEGRIA,AMAZONAS,http://www3.registraduria.gov.co/elecciones/elecciones2014/presidente/2v/99PR2/DPR6003099_L1.htm,http://www3.registraduria.gov.co/elecciones/elecciones2014/presidente/2v/99PR2/DPR6099999_L1.htm,1,1,277,62,60,2,62,0,0,38,61.29,22,35.48
PUERTO ARICA,AMAZONAS,http://www3.registraduria.gov.co/elecciones/elecciones2014/presidente/2v/99PR2/DPR6004099_L1.htm,http://www3.registraduria.gov.co/elecciones/elecciones2014/presidente/2v/99PR2/DPR6099999_L1.htm,2,2,403,119,118,0,118,1,0,71,60.16,47,39.83
PUERTO NARIÑO,AMAZONAS,http://www3.registraduria.gov.co/elecciones/elecciones2014/presidente/2v/99PR2/DPR6000799_L1.htm,http://www3.registraduria.gov.co/elecciones/elecciones2014/presidente/2v/99PR2/DPR6099999_L1.htm,11,11,4014,1788,1723,24,1747,32,9,930,53.23,793,45.39
PUERTO SANTANDER,AMAZONAS,http://www3.registraduria.gov.co/elecciones/elecciones2014/presidente/2v/99PR2/DPR6002199_L1.htm,http://www3.registraduria.gov.co/elecciones/elecciones2014/presidente/2v/99PR2/DPR6099999_L1.htm,2,2,654,179,177,2,179,0,0,106,59.21,71,39.66
TARAPACA,AMAZONAS,http://www3.registraduria.gov.co/elecciones/elecciones2014/presidente/2v/99PR2/DPR6002299_L1.htm,http://www3.registraduria.gov.co/elecciones/elecciones2014/presidente/2v/99PR2/DPR6099999_L1.htm,4,4,1322,435,419,6,425,3,7,301,70.82,118,27.76
ABEJORRAL,ANTIOQUIA,http://www3.registraduria.gov.co/elecciones/elecciones2014/presidente/2v/99PR2/DPR0100499_L1.htm,http://www3.registraduria.gov.co/elecciones/elecciones2014/presidente/2v/99PR2/DPR0199999_L1.htm,41,41,14939,6933,6562,186,6748,132,53,1262,18.70,5300,78.54
ABRIAQUI,ANTIOQUIA,http://www3.registraduria.gov.co/elecciones/elecciones2014/presidente/2v/99PR2/DPR0100799_L1.htm,http://www3.registraduria.gov.co/elecciones/elecciones2014/presidente/2v/99PR2/DPR0199999_L1.htm,6,6,1903,875,822,30,852,17,6,308,36.15,514,60.32
ALEJANDRIA,ANTIOQUIA,http://www3.registraduria.gov.co/elecciones/elecciones2014/presidente/2v/99PR2/DPR0101099_L1.htm,http://www3.registraduria.gov.co/elecciones/elecciones2014/presidente/2v/99PR2/DPR0199999_L1.htm,12,12,4377,2206,2079,84,2163,26,17,1120,51.77,959,44.33
AMAGA,ANTIOQUIA,http://www3.registraduria.gov.co/elecciones/elecciones2014/presidente/2v/99PR2/DPR0101399_L1.htm,http://www3.registraduria.gov.co/elecciones/elecciones2014/presidente/2v/99PR2/DPR0199999_L1.htm,55,55,20893,9157,8200,530,8730,381,46,3496,40.04,4704,53.88
AMALFI,ANTIOQUIA,http://www3.registraduria.gov.co/elecciones/elecciones2014/presidente/2v/99PR2/DPR0101699_L1.htm,http://www3.registraduria.gov.co/elecciones/elecciones2014/presidente/2v/99PR2/DPR0199999_L1.htm,42,42,15588,4945,4432,319,4751,143,51,889,18.71,3543,74.57
ANDES,ANTIOQUIA,http://www3.registraduria.gov.co/elecciones/elecciones2014/presidente/2v/99PR2/DPR0101999_L1.htm,http://www3.registraduria.gov.co/elecciones/elecciones2014/presidente/2v/99PR2/DPR0199999_L1.htm,79,79,32918,14097,13153,563,13716,304,77,2829,20.62,10324,75.26
ANGELOPOLIS,ANTIOQUIA,http://www3.registraduria.gov.co/elecciones/elecciones2014/presidente/2v/99PR2/DPR0102299_L1.htm,http://www3.registraduria.gov.co/elecciones/elecciones2014/presidente/2v/99PR2/DPR0199999_L1.htm,15,15,5466,2353,2154,116,2270,67,16,594,26.16,1560,68.72
ANGOSTURA,ANTIOQUIA,http://www3.registraduria.gov.co/elecciones/elecciones2014/presidente/2v/99PR2/DPR0102599_L1.htm,http://www3.registraduria.gov.co/elecciones/elecciones2014/presidente/2v/99PR2/DPR0199999_L1.htm,24,24,8632,3728,3379,129,3508,158,62,1220,34.77,2159,61.54
ANORI,ANTIOQUIA,http://www3.registraduria.gov.co/elecciones/elecciones2014/presidente/2v/99PR2/DPR0102899_L1.htm,http://www3.registraduria.gov.co/elecciones/elecciones2014/presidente/2v/99PR2/DPR0199999_L1.htm,30,30,10215,2445,2242,119,2361,46,38,1251,52.98,991,41.97
ANTIOQUIA,ANTIOQUIA,http://www3.registraduria.gov.co/elecciones/elecciones2014/presidente/2v/99PR2/DPR0103199_L1.htm,http://www3.registraduria.gov.co/elecciones/elecciones2014/presidente/2v/99PR2/DPR0199999_L1.htm,51,51,18537,8820,7994,462,8456,291,73,3274,38.71,4720,55.81
ANZA,ANTIOQUIA,http://www3.registraduria.gov.co/elecciones/elecciones2014/presidente/2v/99PR2/DPR0103499_L1.htm,http://www3.registraduria.gov.co/elecciones/elecciones2014/presidente/2v/99PR2/DPR0199999_L1.htm,14,14,5322,2480,2338,80,2418,38,24,574,23.73,1764,72.95
APARTADO,ANTIOQUIA,http://www3.registraduria.gov.co/elecciones/elecciones2014/presidente/2v/99PR2/DPR0103599_L1.htm,http://www3.registraduria.gov.co/elecciones/elecciones2014/presidente/2v/99PR2/DPR0199999_L1.htm,206,206,82208,38086,35781,1661,37442,521,123,22550,60.22,13231,35.33
ARBOLETES,ANTIOQUIA,http://www3.registraduria.gov.co/elecciones/elecciones2014/presidente/2v/99PR2/DPR0103799_L1.htm,http://www3.registraduria.gov.co/elecciones/elecciones2014/presidente/2v/99PR2/DPR0199999_L1.htm,59,59,21371,10394,10116,118,10234,94,66,6917,67.58,3199,31.25
ARGELIA,ANTIOQUIA,http://www3.registraduria.gov.co/elecciones/elecciones2014/presidente/2v/99PR2/DPR0103999_L1.htm,http://www3.registraduria.gov.co/elecciones/elecciones2014/presidente/2v/99PR2/DPR0199999_L1.htm,21,21,6489,2968,2875,45,2920,36,12,353,12.08,2522,86.36
ARMENIA,ANTIOQUIA,http://www3.registraduria.gov.co/elecciones/elecciones2014/presidente/2v/99PR2/DPR0104099_L1.htm,http://www3.registraduria.gov.co/elecciones/elecciones2014/presidente/2v/99PR2/DPR0199999_L1.htm,13,13,4831,1969,1809,81,1890,50,29,692,36.61,1117,59.10
BARBOSA,ANTIOQUIA,http://www3.registraduria.gov.co/elecciones/elecciones2014/presidente/2v/99PR2/DPR0104399_L1.htm,http://www3.registraduria.gov.co/elecciones/elecciones2014/presidente/2v/99PR2/DPR0199999_L1.htm,75,75,35505,16340,14645,919,15564,692,84,6173,39.66,8472,54.43
BELLO,ANTIOQUIA,http://www3.registraduria.gov.co/elecciones/elecciones2014/presidente/2v/99PR2/DPR0104999_L1.htm,http://www3.registraduria.gov.co/elecciones/elecciones2014/presidente/2v/99PR2/DPR0199999_L1.htm,695,695,296790,130734,114180,10039,124219,6196,319,48844,39.32,65336,52.59
BELMIRA,ANTIOQUIA,http://www3.registraduria.gov.co/elecciones/elecciones2014/presidente/2v/99PR2/DPR0104699_L1.htm,http://www3.registraduria.gov.co/elecciones/elecciones2014/presidente/2v/99PR2/DPR0199999_L1.htm,14,14,4470,2061,1863,104,1967,82,12,818,41.58,1045,53.12
BETANIA,ANTIOQUIA,http://www3.registraduria.gov.co/elecciones/elecciones2014/presidente/2v/99PR2/DPR0105299_L1.htm,http://www3.registraduria.gov.co/elecciones/elecciones2014/presidente/2v/99PR2/DPR0199999_L1.htm,22,22,8241,3386,3192,102,3294,58,34,477,14.48,2715,82.42
BETULIA,ANTIOQUIA,http://www3.registraduria.gov.co/elecciones/elecciones2014/presidente/2v/99PR2/DPR0105599_L1.htm,http://www3.registraduria.gov.co/elecciones/elecciones2014/presidente/2v/99PR2/DPR0199999_L1.htm,36,36,12791,5847,5565,145,5710,80,57,937,16.40,4628,81.05
BOLIVAR,ANTIOQUIA,http://www3.registraduria.gov.co/elecciones/elecciones2014/presidente/2v/99PR2/DPR0105899_L1.htm,http://www3.registraduria.gov.co/elecciones/elecciones2014/presidente/2v/99PR2/DPR0199999_L1.htm,63,63,23204,9701,9032,398,9430,217,54,1907,20.22,7125,75.55
BRICEÑO,ANTIOQUIA,http://www3.registraduria.gov.co/elecciones/elecciones2014/presidente/2v/99PR2/DPR0106299_L1.htm,http://www3.registraduria.gov.co/elecciones/elecciones2014/presidente/2v/99PR2/DPR0199999_L1.htm,19,19,5819,1289,1159,67,1226,48,15,365,29.77,794,64.76
BURITICA,ANTIOQUIA,http://www3.registraduria.gov.co/elecciones/elecciones2014/presidente/2v/99PR2/DPR0106199_L1.htm,http://www3.registraduria.gov.co/elecciones/elecciones2014/presidente/2v/99PR2/DPR0199999_L1.htm,19,19,6429,2195,2025,89,2114,57,24,752,35.57,1273,60.21
CACERES,ANTIOQUIA,http://www3.registraduria.gov.co/elecciones/elecciones2014/presidente/2v/99PR2/DPR0106499_L1.htm,http://www3.registraduria.gov.co/elecciones/elecciones2014/presidente/2v/99PR2/DPR0199999_L1.htm,53,53,19416,7818,7453,191,7644,128,46,4985,65.21,2468,32.28
CAICEDO,ANTIOQUIA,http://www3.registraduria.gov.co/elecciones/elecciones2014/presidente/2v/99PR2/DPR0106799_L1.htm,http://www3.registraduria.gov.co/elecciones/elecciones2014/presidente/2v/99PR2/DPR0199999_L1.htm,16,16,5784,2882,2704,82,2786,67,29,409,14.68,2295,82.37
CALDAS,ANTIOQUIA,http://www3.registraduria.gov.co/elecciones/elecciones2014/presidente/2v/99PR2/DPR0107099_L1.htm,http://www3.registraduria.gov.co/elecciones/elecciones2014/presidente/2v/99PR2/DPR0199999_L1.htm,121,121,56075,29183,24932,2373,27305,1762,116,13228,48.44,11704,42.86
CAMPAMENTO,ANTIOQUIA,http://www3.registraduria.gov.co/elecciones/elecciones2014/presidente/2v/99PR2/DPR0107399_L1.htm,http://www3.registraduria.gov.co/elecciones/elecciones2014/presidente/2v/99PR2/DPR0199999_L1.htm,17,17,5911,1645,1529,73,1602,30,13,947,59.11,582,36.32
CAÑASGORDAS,ANTIOQUIA,http://www3.registraduria.gov.co/elecciones/elecciones2014/presidente/2v/99PR2/DPR0107699_L1.htm,http://www3.registraduria.gov.co/elecciones/elecciones2014/presidente/2v/99PR2/DPR0199999_L1.htm,35,35,12735,7036,6713,145,6858,125,53,2608,38.02,4105,59.85
CARACOLI,ANTIOQUIA,http://www3.registraduria.gov.co/elecciones/elecciones2014/presidente/2v/99PR2/DPR0107899_L1.htm,http://www3.registraduria.gov.co/elecciones/elecciones2014/presidente/2v/99PR2/DPR0199999_L1.htm,14,14,4639,1750,1642,59,1701,33,16,804,47.26,838,49.26
CARAMANTA,ANTIOQUIA,http://www3.registraduria.gov.co/elecciones/elecciones2014/presidente/2v/99PR2/DPR0107999_L1.htm,http://www3.registraduria.gov.co/elecciones/elecciones2014/presidente/2v/99PR2/DPR0199999_L1.htm,15,15,5141,2613,2476,54,2530,57,26,1102,43.55,1374,54.30
CAREPA,ANTIOQUIA,http://www3.registraduria.gov.co/elecciones/elecciones2014/presidente/2v/99PR2/DPR0108099_L1.htm,http://www3.registraduria.gov.co/elecciones/elecciones2014/presidente/2v/99PR2/DPR0199999_L1.htm,102,102,38452,16677,15862,569,16431,183,63,9669,58.84,6193,37.69
CARMEN DE VIBORAL,ANTIOQUIA,http://www3.registraduria.gov.co/elecciones/elecciones2014/presidente/2v/99PR2/DPR0108299_L1.htm,http://www3.registraduria.gov.co/elecciones/elecciones2014/presidente/2v/99PR2/DPR0199999_L1.htm,83,83,30575,18059,15708,1254,16962,990,107,5484,32.33,10224,60.27
CAROLINA,ANTIOQUIA,http://www3.registraduria.gov.co/elecciones/elecciones2014/presidente/2v/99PR2/DPR0108599_L1.htm,http://www3.registraduria.gov.co/elecciones/elecciones2014/presidente/2v/99PR2/DPR0199999_L1.htm,12,12,4034,1488,1309,92,1401,77,10,571,40.75,738,52.67
CAUCASIA,ANTIOQUIA,http://www3.registraduria.gov.co/elecciones/elecciones2014/presidente/2v/99PR2/DPR0108899_L1.htm,http://www3.registraduria.gov.co/elecciones/elecciones2014/presidente/2v/99PR2/DPR0199999_L1.htm,166,166,60554,25846,23976,1079,25055,687,104,13106,52.30,10870,43.38
CHIGORODO,ANTIOQUIA,http://www3.registraduria.gov.co/elecciones/elecciones2014/presidente/2v/99PR2/DPR0110699_L1.htm,http://www3.registraduria.gov.co/elecciones/elecciones2014/presidente/2v/99PR2/DPR0199999_L1.htm,89,89,41610,18739,17757,667,18424,241,74,12313,66.83,5444,29.54
CISNEROS,ANTIOQUIA,http://www3.registraduria.gov.co/elecciones/elecciones2014/presidente/2v/99PR2/DPR0109199_L1.htm,http://www3.registraduria.gov.co/elecciones/elecciones2014/presidente/2v/99PR2/DPR0199999_L1.htm,29,29,11126,4855,4450,203,4653,153,49,2189,47.04,2261,48.59
COCORNA,ANTIOQUIA,http://www3.registraduria.gov.co/elecciones/elecciones2014/presidente/2v/99PR2/DPR0109499_L1.htm,http://www3.registraduria.gov.co/elecciones/elecciones2014/presidente/2v/99PR2/DPR0199999_L1.htm,36,36,12475,6518,6235,122,6357,101,60,2565,40.34,3670,57.73
CONCEPCION,ANTIOQUIA,http://www3.registraduria.gov.co/elecciones/elecciones2014/presidente/2v/99PR2/DPR0109799_L1.htm,http://www3.registraduria.gov.co/elecciones/elecciones2014/presidente/2v/99PR2/DPR0199999_L1.htm,12,12,4452,2148,2006,68,2074,50,24,520,25.07,1486,71.64
CONCORDIA,ANTIOQUIA,http://www3.registraduria.gov.co/elecciones/elecciones2014/presidente/2v/99PR2/DPR0110099_L1.htm,http://www3.registraduria.gov.co/elecciones/elecciones2014/presidente/2v/99PR2/DPR0199999_L1.htm,41,41,15381,6698,6261,202,6463,118,117,1138,17.60,5123,79.26
COPACABANA,ANTIOQUIA,http://www3.registraduria.gov.co/elecciones/elecciones2014/presidente/2v/99PR2/DPR0110399_L1.htm,http://www3.registraduria.gov.co/elecciones/elecciones2014/presidente/2v/99PR2/DPR0199999_L1.htm,126,126,56567,26678,23213,2029,25242,1362,74,11265,44.62,11948,47.33
DABEIBA,ANTIOQUIA,http://www3.registraduria.gov.co/elecciones/elecciones2014/presidente/2v/99PR2/DPR0110999_L1.htm,http://www3.registraduria.gov.co/elecciones/elecciones2014/presidente/2v/99PR2/DPR0199999_L1.htm,43,43,15863,5951,5636,149,5785,104,62,3402,58.80,2234,38.61
DON MATIAS,ANTIOQUIA,http://www3.registraduria.gov.co/elecciones/elecciones2014/presidente/2v/99PR2/DPR0111299_L1.htm,http://www3.registraduria.gov.co/elecciones/elecciones2014/presidente/2v/99PR2/DPR0199999_L1.htm,42,42,15845,7452,6802,410,7212,188,52,960,13.31,5842,81.00
EBEJICO,ANTIOQUIA,http://www3.registraduria.gov.co/elecciones/elecciones2014/presidente/2v/99PR2/DPR0111599_L1.htm,http://www3.registraduria.gov.co/elecciones/elecciones2014/presidente/2v/99PR2/DPR0199999_L1.htm,31,31,11122,5397,5122,115,5237,122,38,1450,27.68,3672,70.11
EL BAGRE,ANTIOQUIA,http://www3.registraduria.gov.co/elecciones/elecciones2014/presidente/2v/99PR2/DPR0111799_L1.htm,http://www3.registraduria.gov.co/elecciones/elecciones2014/presidente/2v/99PR2/DPR0199999_L1.htm,89,89,33331,10229,9472,444,9916,268,45,4116,41.50,5356,54.01
ENTRERRIOS,ANTIOQUIA,http://www3.registraduria.gov.co/elecciones/elecciones2014/presidente/2v/99PR2/DPR0111899_L1.htm,http://www3.registraduria.gov.co/elecciones/elecciones2014/presidente/2v/99PR2/DPR0199999_L1.htm,19,19,7480,3544,3144,274,3418,108,18,763,22.32,2381,69.66
ENVIGADO,ANTIOQUIA,http://www3.registraduria.gov.co/elecciones/elecciones2014/presidente/2v/99PR2/DPR0112199_L1.htm,http://www3.registraduria.gov.co/elecciones/elecciones2014/presidente/2v/99PR2/DPR0199999_L1.htm,546,546,225101,112797,99714,8344,108058,4552,187,29306,27.12,70408,65.15
FREDONIA,ANTIOQUIA,http://www3.registraduria.gov.co/elecciones/elecciones2014/presidente/2v/99PR2/DPR0112499_L1.htm,http://www3.registraduria.gov.co/elecciones/elecciones2014/presidente/2v/99PR2/DPR0199999_L1.htm,51,51,17648,7264,6679,326,7005,218,41,2240,31.97,4439,63.36
FRONTINO,ANTIOQUIA,http://www3.registraduria.gov.co/elecciones/elecciones2014/presidente/2v/99PR2/DPR0112799_L1.htm,http://www3.registraduria.gov.co/elecciones/elecciones2014/presidente/2v/99PR2/DPR0199999_L1.htm,48,48,16096,5731,5278,229,5507,159,65,3239,58.81,2039,37.02
GIRALDO,ANTIOQUIA,http://www3.registraduria.gov.co/elecciones/elecciones2014/presidente/2v/99PR2/DPR0113099_L1.htm,http://www3.registraduria.gov.co/elecciones/elecciones2014/presidente/2v/99PR2/DPR0199999_L1.htm,11,11,3669,2031,1920,61,1981,41,9,866,43.71,1054,53.20
GIRARDOTA,ANTIOQUIA,http://www3.registraduria.gov.co/elecciones/elecciones2014/presidente/2v/99PR2/DPR0113399_L1.htm,http://www3.registraduria.gov.co/elecciones/elecciones2014/presidente/2v/99PR2/DPR0199999_L1.htm,113,113,42867,19567,17025,1452,18477,1011,79,9765,52.84,7260,39.29
GOMEZ PLATA,ANTIOQUIA,http://www3.registraduria.gov.co/elecciones/elecciones2014/presidente/2v/99PR2/DPR0113699_L1.htm,http://www3.registraduria.gov.co/elecciones/elecciones2014/presidente/2v/99PR2/DPR0199999_L1.htm,22,22,7944,3117,2747,221,2968,126,23,1080,36.38,1667,56.16
GRANADA,ANTIOQUIA,http://www3.registraduria.gov.co/elecciones/elecciones2014/presidente/2v/99PR2/DPR0113999_L1.htm,http://www3.registraduria.gov.co/elecciones/elecciones2014/presidente/2v/99PR2/DPR0199999_L1.htm,27,27,10006,4546,4311,127,4438,67,41,1008,22.71,3303,74.42
GUADALUPE,ANTIOQUIA,http://www3.registraduria.gov.co/elecciones/elecciones2014/presidente/2v/99PR2/DPR0114099_L1.htm,http://www3.registraduria.gov.co/elecciones/elecciones2014/presidente/2v/99PR2/DPR0199999_L1.htm,17,17,5501,1887,1716,91,1807,62,18,1052,58.21,664,36.74
GUARNE,ANTIOQUIA,http://www3.registraduria.gov.co/elecciones/elecciones2014/presidente/2v/99PR2/DPR0114299_L1.htm,http://www3.registraduria.gov.co/elecciones/elecciones2014/presidente/2v/99PR2/DPR0199999_L1.htm,78,78,28996,16866,14715,1135,15850,918,98,4115,25.96,10600,66.87
GUATAPE,ANTIOQUIA,http://www3.registraduria.gov.co/elecciones/elecciones2014/presidente/2v/99PR2/DPR0114599_L1.htm,http://www3.registraduria.gov.co/elecciones/elecciones2014/presidente/2v/99PR2/DPR0199999_L1.htm,16,16,6122,3644,3311,197,3508,118,18,1147,32.69,2164,61.68
HELICONIA,ANTIOQUIA,http://www3.registraduria.gov.co/elecciones/elecciones2014/presidente/2v/99PR2/DPR0114899_L1.htm,http://www3.registraduria.gov.co/elecciones/elecciones2014/presidente/2v/99PR2/DPR0199999_L1.htm,16,16,5801,2622,2407,106,2513,78,31,1169,46.51,1238,49.26
HISPANIA,ANTIOQUIA,http://www3.registraduria.gov.co/elecciones/elecciones2014/presidente/2v/99PR2/DPR0115099_L1.htm,http://www3.registraduria.gov.co/elecciones/elecciones2014/presidente/2v/99PR2/DPR0199999_L1.htm,14,14,5104,2138,2005,89,2094,34,10,909,43.40,1096,52.34
ITAGUI,ANTIOQUIA,http://www3.registraduria.gov.co/elecciones/elecciones2014/presidente/2v/99PR2/DPR0115199_L1.htm,http://www3.registraduria.gov.co/elecciones/elecciones2014/presidente/2v/99PR2/DPR0199999_L1.htm,550,550,231363,109311,96147,8053,104200,4810,301,44781,42.97,51366,49.29
ITUANGO,ANTIOQUIA,http://www3.registraduria.gov.co/elecciones/elecciones2014/presidente/2v/99PR2/DPR0115499_L1.htm,http://www3.registraduria.gov.co/elecciones/elecciones2014/presidente/2v/99PR2/DPR0199999_L1.htm,54,54,16942,4409,3833,302,4135,200,74,2223,53.76,1610,38.93
JARDIN,ANTIOQUIA,http://www3.registraduria.gov.co/elecciones/elecciones2014/presidente/2v/99PR2/DPR0115799_L1.htm,http://www3.registraduria.gov.co/elecciones/elecciones2014/presidente/2v/99PR2/DPR0199999_L1.htm,30,30,11441,6066,5613,295,5908,93,65,1365,23.10,4248,71.90
JERICO,ANTIOQUIA,http://www3.registraduria.gov.co/elecciones/elecciones2014/presidente/2v/99PR2/DPR0116099_L1.htm,http://www3.registraduria.gov.co/elecciones/elecciones2014/presidente/2v/99PR2/DPR0199999_L1.htm,29,29,10975,5194,4834,211,5045,117,32,1024,20.29,3810,75.52
LA CEJA,ANTIOQUIA,http://www3.registraduria.gov.co/elecciones/elecciones2014/presidente/2v/99PR2/DPR0116399_L1.htm,http://www3.registraduria.gov.co/elecciones/elecciones2014/presidente/2v/99PR2/DPR0199999_L1.htm,96,96,41178,24750,21610,1808,23418,1216,116,6685,28.54,14925,63.73
LA ESTRELLA,ANTIOQUIA,http://www3.registraduria.gov.co/elecciones/elecciones2014/presidente/2v/99PR2/DPR0116699_L1.htm,http://www3.registraduria.gov.co/elecciones/elecciones2014/presidente/2v/99PR2/DPR0199999_L1.htm,110,110,48196,23017,19979,1728,21707,1262,48,8534,39.31,11445,52.72
LA PINTADA,ANTIOQUIA,http://www3.registraduria.gov.co/elecciones/elecciones2014/presidente/2v/99PR2/DPR0117099_L1.htm,http://www3.registraduria.gov.co/elecciones/elecciones2014/presidente/2v/99PR2/DPR0199999_L1.htm,16,16,6109,3141,2961,82,3043,68,30,929,30.52,2032,66.77
LA UNION,ANTIOQUIA,http://www3.registraduria.gov.co/elecciones/elecciones2014/presidente/2v/99PR2/DPR0116999_L1.htm,http://www3.registraduria.gov.co/elecciones/elecciones2014/presidente/2v/99PR2/DPR0199999_L1.htm,40,40,15294,8929,8172,455,8627,269,33,2107,24.42,6065,70.30
LIBORINA,ANTIOQUIA,http://www3.registraduria.gov.co/elecciones/elecciones2014/presidente/2v/99PR2/DPR0117299_L1.htm,http://www3.registraduria.gov.co/elecciones/elecciones2014/presidente/2v/99PR2/DPR0199999_L1.htm,25,25,8849,4210,4006,111,4117,69,24,1114,27.05,2892,70.24
MACEO,ANTIOQUIA,http://www3.registraduria.gov.co/elecciones/elecciones2014/presidente/2v/99PR2/DPR0117599_L1.htm,http://www3.registraduria.gov.co/elecciones/elecciones2014/presidente/2v/99PR2/DPR0199999_L1.htm,20,20,7253,2813,2676,90,2766,31,16,1230,44.46,1446,52.27
MARINILLA,ANTIOQUIA,http://www3.registraduria.gov.co/elecciones/elecciones2014/presidente/2v/99PR2/DPR0117899_L1.htm,http://www3.registraduria.gov.co/elecciones/elecciones2014/presidente/2v/99PR2/DPR0199999_L1.htm,79,79,36465,20139,18320,1049,19369,695,75,6130,31.64,12190,62.93
MEDELLIN,ANTIOQUIA,http://www3.registraduria.gov.co/elecciones/elecciones2014/presidente/2v/99PR2/DPR0100199_L1.htm,http://www3.registraduria.gov.co/elecciones/elecciones2014/presidente/2v/99PR2/DPR0199999_L1.htm,3918,3918,1412495,739244,656908,53449,710357,27384,1503,208540,29.35,448368,63.11
MONTEBELLO,ANTIOQUIA,http://www3.registraduria.gov.co/elecciones/elecciones2014/presidente/2v/99PR2/DPR0118199_L1.htm,http://www3.registraduria.gov.co/elecciones/elecciones2014/presidente/2v/99PR2/DPR0199999_L1.htm,16,16,5911,2775,2525,135,2660,71,44,746,28.04,1779,66.87
MURINDO,ANTIOQUIA,http://www3.registraduria.gov.co/elecciones/elecciones2014/presidente/2v/99PR2/DPR0118499_L1.htm,http://www3.registraduria.gov.co/elecciones/elecciones2014/presidente/2v/99PR2/DPR0199999_L1.htm,9,9,2508,1132,1108,3,1111,6,15,1060,95.40,48,4.32
MUTATA,ANTIOQUIA,http://www3.registraduria.gov.co/elecciones/elecciones2014/presidente/2v/99PR2/DPR0118799_L1.htm,http://www3.registraduria.gov.co/elecciones/elecciones2014/presidente/2v/99PR2/DPR0199999_L1.htm,33,33,12039,4535,4371,102,4473,44,18,3279,73.30,1092,24.41
NARIÑO,ANTIOQUIA,http://www3.registraduria.gov.co/elecciones/elecciones2014/presidente/2v/99PR2/DPR0119099_L1.htm,http://www3.registraduria.gov.co/elecciones/elecciones2014/presidente/2v/99PR2/DPR0199999_L1.htm,27,27,8867,3966,3820,60,3880,46,40,554,14.27,3266,84.17
NECHI,ANTIOQUIA,http://www3.registraduria.gov.co/elecciones/elecciones2014/presidente/2v/99PR2/DPR0119199_L1.htm,http://www3.registraduria.gov.co/elecciones/elecciones2014/presidente/2v/99PR2/DPR0199999_L1.htm,47,47,17285,6053,5847,97,5944,68,41,2489,41.87,3358,56.49
NECOCLI,ANTIOQUIA,http://www3.registraduria.gov.co/elecciones/elecciones2014/presidente/2v/99PR2/DPR0119299_L1.htm,http://www3.registraduria.gov.co/elecciones/elecciones2014/presidente/2v/99PR2/DPR0199999_L1.htm,82,82,30732,13411,12967,192,13159,160,92,8782,66.73,4185,31.80
OLAYA,ANTIOQUIA,http://www3.registraduria.gov.co/elecciones/elecciones2014/presidente/2v/99PR2/DPR0119399_L1.htm,http://www3.registraduria.gov.co/elecciones/elecciones2014/presidente/2v/99PR2/DPR0199999_L1.htm,9,9,2769,1311,1244,40,1284,19,8,298,23.20,946,73.67
PEÑOL,ANTIOQUIA,http://www3.registraduria.gov.co/elecciones/elecciones2014/presidente/2v/99PR2/DPR0119699_L1.htm,http://www3.registraduria.gov.co/elecciones/elecciones2014/presidente/2v/99PR2/DPR0199999_L1.htm,38,38,14621,6900,6492,253,6745,129,26,2035,30.17,4457,66.07
PEQUE,ANTIOQUIA,http://www3.registraduria.gov.co/elecciones/elecciones2014/presidente/2v/99PR2/DPR0119999_L1.htm,http://www3.registraduria.gov.co/elecciones/elecciones2014/presidente/2v/99PR2/DPR0199999_L1.htm,18,18,5638,2849,2751,52,2803,36,10,1325,47.27,1426,50.87
PUEBLORRICO,ANTIOQUIA,http://www3.registraduria.gov.co/elecciones/elecciones2014/presidente/2v/99PR2/DPR0120299_L1.htm,http://www3.registraduria.gov.co/elecciones/elecciones2014/presidente/2v/99PR2/DPR0199999_L1.htm,18,18,6824,3139,2974,91,3065,52,22,539,17.58,2435,79.44
PUERTO BERRIO,ANTIOQUIA,http://www3.registraduria.gov.co/elecciones/elecciones2014/presidente/2v/99PR2/DPR0120599_L1.htm,http://www3.registraduria.gov.co/elecciones/elecciones2014/presidente/2v/99PR2/DPR0199999_L1.htm,92,92,33297,11736,10874,515,11389,297,50,4944,43.41,5930,52.06
PUERTO NARE-LA MAGDALENA,ANTIOQUIA,http://www3.registraduria.gov.co/elecciones/elecciones2014/presidente/2v/99PR2/DPR0116899_L1.htm,http://www3.registraduria.gov.co/elecciones/elecciones2014/presidente/2v/99PR2/DPR0199999_L1.htm,32,32,11662,5245,5039,109,5148,83,14,3634,70.59,1405,27.29
PUERTO TRIUNFO,ANTIOQUIA,http://www3.registraduria.gov.co/elecciones/elecciones2014/presidente/2v/99PR2/DPR0120699_L1.htm,http://www3.registraduria.gov.co/elecciones/elecciones2014/presidente/2v/99PR2/DPR0199999_L1.htm,34,34,12172,5730,5415,178,5593,99,38,1719,30.73,3696,66.08
REMEDIOS,ANTIOQUIA,http://www3.registraduria.gov.co/elecciones/elecciones2014/presidente/2v/99PR2/DPR0120899_L1.htm,http://www3.registraduria.gov.co/elecciones/elecciones2014/presidente/2v/99PR2/DPR0199999_L1.htm,41,41,15888,3857,3457,263,3720,127,10,1640,44.08,1817,48.84
RETIRO,ANTIOQUIA,http://www3.registraduria.gov.co/elecciones/elecciones2014/presidente/2v/99PR2/DPR0121199_L1.htm,http://www3.registraduria.gov.co/elecciones/elecciones2014/presidente/2v/99PR2/DPR0199999_L1.htm,37,37,14090,8627,7833,460,8293,285,49,2178,26.26,5655,68.19
RIONEGRO,ANTIOQUIA,http://www3.registraduria.gov.co/elecciones/elecciones2014/presidente/2v/99PR2/DPR0121499_L1.htm,http://www3.registraduria.gov.co/elecciones/elecciones2014/presidente/2v/99PR2/DPR0199999_L1.htm,216,216,87238,51099,44763,3624,48387,2543,169,14155,29.25,30608,63.25
SABANALARGA,ANTIOQUIA,http://www3.registraduria.gov.co/elecciones/elecciones2014/presidente/2v/99PR2/DPR0121799_L1.htm,http://www3.registraduria.gov.co/elecciones/elecciones2014/presidente/2v/99PR2/DPR0199999_L1.htm,19,19,6723,3184,3011,92,3103,55,26,850,27.39,2161,69.64
SABANETA,ANTIOQUIA,http://www3.registraduria.gov.co/elecciones/elecciones2014/presidente/2v/99PR2/DPR0121899_L1.htm,http://www3.registraduria.gov.co/elecciones/elecciones2014/presidente/2v/99PR2/DPR0199999_L1.htm,125,125,54213,31256,27950,2115,30065,1130,61,11292,37.55,16658,55.40
SALGAR,ANTIOQUIA,http://www3.registraduria.gov.co/elecciones/elecciones2014/presidente/2v/99PR2/DPR0122099_L1.htm,http://www3.registraduria.gov.co/elecciones/elecciones2014/presidente/2v/99PR2/DPR0199999_L1.htm,35,35,13000,5020,4766,105,4871,91,58,667,13.69,4099,84.15
SAN ANDRES,ANTIOQUIA,http://www3.registraduria.gov.co/elecciones/elecciones2014/presidente/2v/99PR2/DPR0122399_L1.htm,http://www3.registraduria.gov.co/elecciones/elecciones2014/presidente/2v/99PR2/DPR0199999_L1.htm,17,17,4862,1910,1693,115,1808,88,14,409,22.62,1284,71.01
SAN CARLOS,ANTIOQUIA,http://www3.registraduria.gov.co/elecciones/elecciones2014/presidente/2v/99PR2/DPR0122699_L1.htm,http://www3.registraduria.gov.co/elecciones/elecciones2014/presidente/2v/99PR2/DPR0199999_L1.htm,35,35,12760,6121,5852,123,5975,98,48,3086,51.64,2766,46.29
SAN FRANCISCO,ANTIOQUIA,http://www3.registraduria.gov.co/elecciones/elecciones2014/presidente/2v/99PR2/DPR0122799_L1.htm,http://www3.registraduria.gov.co/elecciones/elecciones2014/presidente/2v/99PR2/DPR0199999_L1.htm,16,16,5950,2426,2328,42,2370,36,20,1142,48.18,1186,50.04
SAN JERONIMO,ANTIOQUIA,http://www3.registraduria.gov.co/elecciones/elecciones2014/presidente/2v/99PR2/DPR0122999_L1.htm,http://www3.registraduria.gov.co/elecciones/elecciones2014/presidente/2v/99PR2/DPR0199999_L1.htm,31,31,11716,5114,4748,202,4950,134,30,1680,33.93,3068,61.97
SAN JOSE DE LA MONTAÑA,ANTIOQUIA,http://www3.registraduria.gov.co/elecciones/elecciones2014/presidente/2v/99PR2/DPR0123099_L1.htm,http://www3.registraduria.gov.co/elecciones/elecciones2014/presidente/2v/99PR2/DPR0199999_L1.htm,8,8,3063,1437,1312,75,1387,39,11,401,28.91,911,65.68
SAN JUAN DE URABA,ANTIOQUIA,http://www3.registraduria.gov.co/elecciones/elecciones2014/presidente/2v/99PR2/DPR0123199_L1.htm,http://www3.registraduria.gov.co/elecciones/elecciones2014/presidente/2v/99PR2/DPR0199999_L1.htm,42,42,15618,7349,7171,57,7228,64,57,5606,77.55,1565,21.65
SAN LUIS,ANTIOQUIA,http://www3.registraduria.gov.co/elecciones/elecciones2014/presidente/2v/99PR2/DPR0123299_L1.htm,http://www3.registraduria.gov.co/elecciones/elecciones2014/presidente/2v/99PR2/DPR0199999_L1.htm,30,30,10126,4614,4374,139,4513,70,31,1375,30.46,2999,66.45
SAN PEDRO,ANTIOQUIA,http://www3.registraduria.gov.co/elecciones/elecciones2014/presidente/2v/99PR2/DPR0123599_L1.htm,http://www3.registraduria.gov.co/elecciones/elecciones2014/presidente/2v/99PR2/DPR0199999_L1.htm,47,47,17715,8675,7494,707,8201,437,37,1564,19.07,5930,72.30
SAN PEDRO DE URABA,ANTIOQUIA,http://www3.registraduria.gov.co/elecciones/elecciones2014/presidente/2v/99PR2/DPR0123799_L1.htm,http://www3.registraduria.gov.co/elecciones/elecciones2014/presidente/2v/99PR2/DPR0199999_L1.htm,63,63,23674,9787,9479,126,9605,119,63,5220,54.34,4259,44.34
SAN RAFAEL,ANTIOQUIA,http://www3.registraduria.gov.co/elecciones/elecciones2014/presidente/2v/99PR2/DPR0123899_L1.htm,http://www3.registraduria.gov.co/elecciones/elecciones2014/presidente/2v/99PR2/DPR0199999_L1.htm,31,31,11793,5841,5457,198,5655,145,41,2552,45.12,2905,51.37
SAN ROQUE,ANTIOQUIA,http://www3.registraduria.gov.co/elecciones/elecciones2014/presidente/2v/99PR2/DPR0124199_L1.htm,http://www3.registraduria.gov.co/elecciones/elecciones2014/presidente/2v/99PR2/DPR0199999_L1.htm,37,37,13752,5674,5275,215,5490,118,66,1489,27.12,3786,68.96
SAN VICENTE,ANTIOQUIA,http://www3.registraduria.gov.co/elecciones/elecciones2014/presidente/2v/99PR2/DPR0124499_L1.htm,http://www3.registraduria.gov.co/elecciones/elecciones2014/presidente/2v/99PR2/DPR0199999_L1.htm,45,45,15748,8805,8265,270,8535,221,49,1559,18.26,6706,78.57
SANTA BARBARA,ANTIOQUIA,http://www3.registraduria.gov.co/elecciones/elecciones2014/presidente/2v/99PR2/DPR0124799_L1.htm,http://www3.registraduria.gov.co/elecciones/elecciones2014/presidente/2v/99PR2/DPR0199999_L1.htm,57,57,21397,9053,8175,493,8668,322,63,2897,33.42,5278,60.89
SANTA ROSA DE OSOS,ANTIOQUIA,http://www3.registraduria.gov.co/elecciones/elecciones2014/presidente/2v/99PR2/DPR0125099_L1.htm,http://www3.registraduria.gov.co/elecciones/elecciones2014/presidente/2v/99PR2/DPR0199999_L1.htm,65,65,24207,13048,11518,823,12341,580,127,2398,19.43,9120,73.90
SANTO DOMINGO,ANTIOQUIA,http://www3.registraduria.gov.co/elecciones/elecciones2014/presidente/2v/99PR2/DPR0125399_L1.htm,http://www3.registraduria.gov.co/elecciones/elecciones2014/presidente/2v/99PR2/DPR0199999_L1.htm,25,25,8481,4111,3776,162,3938,121,52,1454,36.92,2322,58.96
SANTUARIO,ANTIOQUIA,http://www3.registraduria.gov.co/elecciones/elecciones2014/presidente/2v/99PR2/DPR0125699_L1.htm,http://www3.registraduria.gov.co/elecciones/elecciones2014/presidente/2v/99PR2/DPR0199999_L1.htm,67,67,25148,14017,13128,508,13636,295,86,2716,19.91,10412,76.35
SEGOVIA,ANTIOQUIA,http://www3.registraduria.gov.co/elecciones/elecciones2014/presidente/2v/99PR2/DPR0125999_L1.htm,http://www3.registraduria.gov.co/elecciones/elecciones2014/presidente/2v/99PR2/DPR0199999_L1.htm,64,64,24294,5421,4835,404,5239,162,20,2669,50.94,2166,41.34
SONSON,ANTIOQUIA,http://www3.registraduria.gov.co/elecciones/elecciones2014/presidente/2v/99PR2/DPR0126299_L1.htm,http://www3.registraduria.gov.co/elecciones/elecciones2014/presidente/2v/99PR2/DPR0199999_L1.htm,84,84,26652,12916,12061,468,12529,289,98,2226,17.76,9835,78.49
SOPETRAN,ANTIOQUIA,http://www3.registraduria.gov.co/elecciones/elecciones2014/presidente/2v/99PR2/DPR0126599_L1.htm,http://www3.registraduria.gov.co/elecciones/elecciones2014/presidente/2v/99PR2/DPR0199999_L1.htm,34,34,11498,5434,5029,191,5220,171,43,2238,42.87,2791,53.46
TAMESIS,ANTIOQUIA,http://www3.registraduria.gov.co/elecciones/elecciones2014/presidente/2v/99PR2/DPR0126899_L1.htm,http://www3.registraduria.gov.co/elecciones/elecciones2014/presidente/2v/99PR2/DPR0199999_L1.htm,38,38,14122,6474,5942,314,6256,171,47,1699,27.15,4243,67.82
TARAZA,ANTIOQUIA,http://www3.registraduria.gov.co/elecciones/elecciones2014/presidente/2v/99PR2/DPR0127099_L1.htm,http://www3.registraduria.gov.co/elecciones/elecciones2014/presidente/2v/99PR2/DPR0199999_L1.htm,67,67,24855,7473,6950,268,7218,216,39,4777,66.18,2173,30.10
TARSO,ANTIOQUIA,http://www3.registraduria.gov.co/elecciones/elecciones2014/presidente/2v/99PR2/DPR0127199_L1.htm,http://www3.registraduria.gov.co/elecciones/elecciones2014/presidente/2v/99PR2/DPR0199999_L1.htm,15,15,5647,2613,2473,69,2542,48,23,1245,48.97,1228,48.30
TITIRIBI,ANTIOQUIA,http://www3.registraduria.gov.co/elecciones/elecciones2014/presidente/2v/99PR2/DPR0127499_L1.htm,http://www3.registraduria.gov.co/elecciones/elecciones2014/presidente/2v/99PR2/DPR0199999_L1.htm,25,25,8664,3307,3001,168,3169,106,32,1515,47.80,1486,46.89
TOLEDO,ANTIOQUIA,http://www3.registraduria.gov.co/elecciones/elecciones2014/presidente/2v/99PR2/DPR0127799_L1.htm,http://www3.registraduria.gov.co/elecciones/elecciones2014/presidente/2v/99PR2/DPR0199999_L1.htm,12,12,4226,1577,1379,101,1480,67,30,382,25.81,997,67.36
TURBO,ANTIOQUIA,http://www3.registraduria.gov.co/elecciones/elecciones2014/presidente/2v/99PR2/DPR0128099_L1.htm,http://www3.registraduria.gov.co/elecciones/elecciones2014/presidente/2v/99PR2/DPR0199999_L1.htm,207,207,78990,37471,36179,735,36914,413,144,25996,70.42,10183,27.58
URAMITA,ANTIOQUIA,http://www3.registraduria.gov.co/elecciones/elecciones2014/presidente/2v/99PR2/DPR0128299_L1.htm,http://www3.registraduria.gov.co/elecciones/elecciones2014/presidente/2v/99PR2/DPR0199999_L1.htm,17,17,6039,2542,2423,46,2469,57,16,1540,62.37,883,35.76
URRAO,ANTIOQUIA,http://www3.registraduria.gov.co/elecciones/elecciones2014/presidente/2v/99PR2/DPR0128399_L1.htm,http://www3.registraduria.gov.co/elecciones/elecciones2014/presidente/2v/99PR2/DPR0199999_L1.htm,57,57,21012,7917,7185,440,7625,193,99,2213,29.02,4972,65.20
VALDIVIA,ANTIOQUIA,http://www3.registraduria.gov.co/elecciones/elecciones2014/presidente/2v/99PR2/DPR0128699_L1.htm,http://www3.registraduria.gov.co/elecciones/elecciones2014/presidente/2v/99PR2/DPR0199999_L1.htm,31,31,11471,3097,2920,95,3015,59,23,1672,55.45,1248,41.39
VALPARAISO,ANTIOQUIA,http://www3.registraduria.gov.co/elecciones/elecciones2014/presidente/2v/99PR2/DPR0128999_L1.htm,http://www3.registraduria.gov.co/elecciones/elecciones2014/presidente/2v/99PR2/DPR0199999_L1.htm,16,16,5654,2678,2494,93,2587,76,15,1153,44.56,1341,51.83
VEGACHI,ANTIOQUIA,http://www3.registraduria.gov.co/elecciones/elecciones2014/presidente/2v/99PR2/DPR0129099_L1.htm,http://www3.registraduria.gov.co/elecciones/elecciones2014/presidente/2v/99PR2/DPR0199999_L1.htm,27,27,9973,3346,3117,133,3250,69,27,936,28.80,2181,67.10
VENECIA,ANTIOQUIA,http://www3.registraduria.gov.co/elecciones/elecciones2014/presidente/2v/99PR2/DPR0129299_L1.htm,http://www3.registraduria.gov.co/elecciones/elecciones2014/presidente/2v/99PR2/DPR0199999_L1.htm,31,31,10635,4480,4172,186,4358,98,24,1645,37.74,2527,57.98
VIGIA DEL FUERTE,ANTIOQUIA,http://www3.registraduria.gov.co/elecciones/elecciones2014/presidente/2v/99PR2/DPR0129199_L1.htm,http://www3.registraduria.gov.co/elecciones/elecciones2014/presidente/2v/99PR2/DPR0199999_L1.htm,18,18,5037,2179,2123,22,2145,18,16,1807,84.24,316,14.73
YALI,ANTIOQUIA,http://www3.registraduria.gov.co/elecciones/elecciones2014/presidente/2v/99PR2/DPR0129399_L1.htm,http://www3.registraduria.gov.co/elecciones/elecciones2014/presidente/2v/99PR2/DPR0199999_L1.htm,14,14,5481,1808,1707,63,1770,20,18,757,42.76,950,53.67
YARUMAL,ANTIOQUIA,http://www3.registraduria.gov.co/elecciones/elecciones2014/presidente/2v/99PR2/DPR0129599_L1.htm,http://www3.registraduria.gov.co/elecciones/elecciones2014/presidente/2v/99PR2/DPR0199999_L1.htm,79,79,31961,11566,10238,766,11004,484,78,2408,21.88,7830,71.15
YOLOMBO,ANTIOQUIA,http://www3.registraduria.gov.co/elecciones/elecciones2014/presidente/2v/99PR2/DPR0129899_L1.htm,http://www3.registraduria.gov.co/elecciones/elecciones2014/presidente/2v/99PR2/DPR0199999_L1.htm,43,43,15546,5193,4794,230,5024,115,54,1727,34.37,3067,61.04
YONDO-CASABE,ANTIOQUIA,http://www3.registraduria.gov.co/elecciones/elecciones2014/presidente/2v/99PR2/DPR0130099_L1.htm,http://www3.registraduria.gov.co/elecciones/elecciones2014/presidente/2v/99PR2/DPR0199999_L1.htm,31,31,11075,5648,5390,127,5517,102,29,3643,66.03,1747,31.66
ZARAGOZA,ANTIOQUIA,http://www3.registraduria.gov.co/elecciones/elecciones2014/presidente/2v/99PR2/DPR0130199_L1.htm,http://www3.registraduria.gov.co/elecciones/elecciones2014/presidente/2v/99PR2/DPR0199999_L1.htm,46,46,17765,5448,5042,208,5250,148,50,2849,54.26,2193,41.77
ARAUCA,ARAUCA,http://www3.registraduria.gov.co/elecciones/elecciones2014/presidente/2v/99PR2/DPR4000199_L1.htm,http://www3.registraduria.gov.co/elecciones/elecciones2014/presidente/2v/99PR2/DPR4099999_L1.htm,160,160,62385,29398,27790,937,28727,565,106,8720,30.35,19070,66.38
ARAUQUITA,ARAUCA,http://www3.registraduria.gov.co/elecciones/elecciones2014/presidente/2v/99PR2/DPR4001099_L1.htm,http://www3.registraduria.gov.co/elecciones/elecciones2014/presidente/2v/99PR2/DPR4099999_L1.htm,68,68,24762,11461,10935,271,11206,192,63,8410,75.04,2525,22.53
CRAVO NORTE,ARAUCA,http://www3.registraduria.gov.co/elecciones/elecciones2014/presidente/2v/99PR2/DPR4001599_L1.htm,http://www3.registraduria.gov.co/elecciones/elecciones2014/presidente/2v/99PR2/DPR4099999_L1.htm,14,14,3387,1557,1469,44,1513,32,12,598,39.52,871,57.56
FORTUL,ARAUCA,http://www3.registraduria.gov.co/elecciones/elecciones2014/presidente/2v/99PR2/DPR4001799_L1.htm,http://www3.registraduria.gov.co/elecciones/elecciones2014/presidente/2v/99PR2/DPR4099999_L1.htm,27,27,9836,5048,4835,111,4946,72,30,3888,78.60,947,19.14
PUERTO RONDON,ARAUCA,http://www3.registraduria.gov.co/elecciones/elecciones2014/presidente/2v/99PR2/DPR4002099_L1.htm,http://www3.registraduria.gov.co/elecciones/elecciones2014/presidente/2v/99PR2/DPR4099999_L1.htm,15,15,3459,1560,1508,32,1540,11,9,521,33.83,987,64.09
SARAVENA,ARAUCA,http://www3.registraduria.gov.co/elecciones/elecciones2014/presidente/2v/99PR2/DPR4002599_L1.htm,http://www3.registraduria.gov.co/elecciones/elecciones2014/presidente/2v/99PR2/DPR4099999_L1.htm,77,77,28963,13734,12840,481,13321,337,76,7569,56.82,5271,39.56
TAME,ARAUCA,http://www3.registraduria.gov.co/elecciones/elecciones2014/presidente/2v/99PR2/DPR4000599_L1.htm,http://www3.registraduria.gov.co/elecciones/elecciones2014/presidente/2v/99PR2/DPR4099999_L1.htm,82,82,29423,15092,14362,414,14776,228,88,7599,51.42,6763,45.77
BARANOA,ATLANTICO,http://www3.registraduria.gov.co/elecciones/elecciones2014/presidente/2v/99PR2/DPR0300499_L1.htm,http://www3.registraduria.gov.co/elecciones/elecciones2014/presidente/2v/99PR2/DPR0399999_L1.htm,116,116,44081,24934,24409,285,24694,184,56,21673,87.76,2736,11.07
BARRANQUILLA,ATLANTICO,http://www3.registraduria.gov.co/elecciones/elecciones2014/presidente/2v/99PR2/DPR0300199_L1.htm,http://www3.registraduria.gov.co/elecciones/elecciones2014/presidente/2v/99PR2/DPR0399999_L1.htm,2805,2805,968361,365516,353767,7692,361459,3531,526,268035,74.15,85732,23.71
CAMPO DE LA CRUZ,ATLANTICO,http://www3.registraduria.gov.co/elecciones/elecciones2014/presidente/2v/99PR2/DPR0300799_L1.htm,http://www3.registraduria.gov.co/elecciones/elecciones2014/presidente/2v/99PR2/DPR0399999_L1.htm,49,49,18710,6636,6306,47,6353,91,192,4480,70.51,1826,28.74
CANDELARIA,ATLANTICO,http://www3.registraduria.gov.co/elecciones/elecciones2014/presidente/2v/99PR2/DPR0301099_L1.htm,http://www3.registraduria.gov.co/elecciones/elecciones2014/presidente/2v/99PR2/DPR0399999_L1.htm,28,28,10734,5602,5533,25,5558,33,11,4907,88.28,626,11.26
GALAPA,ATLANTICO,http://www3.registraduria.gov.co/elecciones/elecciones2014/presidente/2v/99PR2/DPR0301399_L1.htm,http://www3.registraduria.gov.co/elecciones/elecciones2014/presidente/2v/99PR2/DPR0399999_L1.htm,87,87,33272,15815,15455,190,15645,135,35,13373,85.47,2082,13.30
JUAN DE ACOSTA,ATLANTICO,http://www3.registraduria.gov.co/elecciones/elecciones2014/presidente/2v/99PR2/DPR0301699_L1.htm,http://www3.registraduria.gov.co/elecciones/elecciones2014/presidente/2v/99PR2/DPR0399999_L1.htm,47,47,17379,7087,6923,81,7004,69,14,5392,76.98,1531,21.85
LURUACO,ATLANTICO,http://www3.registraduria.gov.co/elecciones/elecciones2014/presidente/2v/99PR2/DPR0301999_L1.htm,http://www3.registraduria.gov.co/elecciones/elecciones2014/presidente/2v/99PR2/DPR0399999_L1.htm,60,60,22715,10121,9843,110,9953,142,26,7502,75.37,2341,23.52
MALAMBO,ATLANTICO,http://www3.registraduria.gov.co/elecciones/elecciones2014/presidente/2v/99PR2/DPR0302299_L1.htm,http://www3.registraduria.gov.co/elecciones/elecciones2014/presidente/2v/99PR2/DPR0399999_L1.htm,162,162,67327,30286,29496,458,29954,285,47,24006,80.14,5490,18.32
MANATI,ATLANTICO,http://www3.registraduria.gov.co/elecciones/elecciones2014/presidente/2v/99PR2/DPR0302599_L1.htm,http://www3.registraduria.gov.co/elecciones/elecciones2014/presidente/2v/99PR2/DPR0399999_L1.htm,33,33,12812,5769,5707,22,5729,29,11,5136,89.64,571,9.96
PALMAR DE VARELA,ATLANTICO,http://www3.registraduria.gov.co/elecciones/elecciones2014/presidente/2v/99PR2/DPR0302899_L1.htm,http://www3.registraduria.gov.co/elecciones/elecciones2014/presidente/2v/99PR2/DPR0399999_L1.htm,49,49,19081,9227,9082,65,9147,68,12,8238,90.06,844,9.22
PIOJO,ATLANTICO,http://www3.registraduria.gov.co/elecciones/elecciones2014/presidente/2v/99PR2/DPR0303199_L1.htm,http://www3.registraduria.gov.co/elecciones/elecciones2014/presidente/2v/99PR2/DPR0399999_L1.htm,16,16,5662,2598,2558,7,2565,24,9,1756,68.46,802,31.26
POLONUEVO,ATLANTICO,http://www3.registraduria.gov.co/elecciones/elecciones2014/presidente/2v/99PR2/DPR0303499_L1.htm,http://www3.registraduria.gov.co/elecciones/elecciones2014/presidente/2v/99PR2/DPR0399999_L1.htm,30,30,11647,6774,6629,64,6693,69,12,6024,90.00,605,9.03
PONEDERA,ATLANTICO,http://www3.registraduria.gov.co/elecciones/elecciones2014/presidente/2v/99PR2/DPR0303599_L1.htm,http://www3.registraduria.gov.co/elecciones/elecciones2014/presidente/2v/99PR2/DPR0399999_L1.htm,46,46,17219,7941,7791,60,7851,67,23,5600,71.32,2191,27.90
PUERTO COLOMBIA,ATLANTICO,http://www3.registraduria.gov.co/elecciones/elecciones2014/presidente/2v/99PR2/DPR0303799_L1.htm,http://www3.registraduria.gov.co/elecciones/elecciones2014/presidente/2v/99PR2/DPR0399999_L1.htm,81,81,30558,13908,13572,202,13774,112,22,10746,78.01,2826,20.51
REPELON,ATLANTICO,http://www3.registraduria.gov.co/elecciones/elecciones2014/presidente/2v/99PR2/DPR0304099_L1.htm,http://www3.registraduria.gov.co/elecciones/elecciones2014/presidente/2v/99PR2/DPR0399999_L1.htm,47,47,17487,9089,8970,47,9017,59,13,8138,90.25,832,9.22
SABANAGRANDE,ATLANTICO,http://www3.registraduria.gov.co/elecciones/elecciones2014/presidente/2v/99PR2/DPR0304399_L1.htm,http://www3.registraduria.gov.co/elecciones/elecciones2014/presidente/2v/99PR2/DPR0399999_L1.htm,58,58,22004,11515,11226,161,11387,103,25,9440,82.90,1786,15.68
SABANALARGA,ATLANTICO,http://www3.registraduria.gov.co/elecciones/elecciones2014/presidente/2v/99PR2/DPR0304699_L1.htm,http://www3.registraduria.gov.co/elecciones/elecciones2014/presidente/2v/99PR2/DPR0399999_L1.htm,160,160,61435,35907,35212,336,35548,313,46,30956,87.08,4256,11.97
SANTA LUCIA,ATLANTICO,http://www3.registraduria.gov.co/elecciones/elecciones2014/presidente/2v/99PR2/DPR0304799_L1.htm,http://www3.registraduria.gov.co/elecciones/elecciones2014/presidente/2v/99PR2/DPR0399999_L1.htm,25,25,9210,4231,4171,12,4183,46,2,3256,77.83,915,21.87
SANTO TOMAS,ATLANTICO,http://www3.registraduria.gov.co/elecciones/elecciones2014/presidente/2v/99PR2/DPR0304999_L1.htm,http://www3.registraduria.gov.co/elecciones/elecciones2014/presidente/2v/99PR2/DPR0399999_L1.htm,65,65,24929,11597,11359,133,11492,78,27,9852,85.72,1507,13.11
SOLEDAD,ATLANTICO,http://www3.registraduria.gov.co/elecciones/elecciones2014/presidente/2v/99PR2/DPR0305299_L1.htm,http://www3.registraduria.gov.co/elecciones/elecciones2014/presidente/2v/99PR2/DPR0399999_L1.htm,644,644,253922,103478,100631,1636,102267,1047,164,82478,80.64,18153,17.75
SUAN,ATLANTICO,http://www3.registraduria.gov.co/elecciones/elecciones2014/presidente/2v/99PR2/DPR0305599_L1.htm,http://www3.registraduria.gov.co/elecciones/elecciones2014/presidente/2v/99PR2/DPR0399999_L1.htm,24,24,9273,4359,4306,19,4325,30,4,3765,87.05,541,12.50
TUBARA,ATLANTICO,http://www3.registraduria.gov.co/elecciones/elecciones2014/presidente/2v/99PR2/DPR0305899_L1.htm,http://www3.registraduria.gov.co/elecciones/elecciones2014/presidente/2v/99PR2/DPR0399999_L1.htm,26,26,9569,5310,5207,46,5253,43,14,4411,83.97,796,15.15
USIACURI,ATLANTICO,http://www3.registraduria.gov.co/elecciones/elecciones2014/presidente/2v/99PR2/DPR0306199_L1.htm,http://www3.registraduria.gov.co/elecciones/elecciones2014/presidente/2v/99PR2/DPR0399999_L1.htm,19,19,7300,4249,4178,29,4207,36,6,3778,89.80,400,9.50
BOGOTA D.C.,BOGOTA D.C.,http://www3.registraduria.gov.co/elecciones/elecciones2014/presidente/2v/99PR2/DPR1699999_L1.htm,http://www3.registraduria.gov.co/elecciones/elecciones2014/presidente/2v/99PR2/DPR1699999_L1.htm,14232,14232,5204003,2631907,2418779,135053,2553832,75902,2173,1341963,52.54,1076816,42.16
ACHI,BOLIVAR,http://www3.registraduria.gov.co/elecciones/elecciones2014/presidente/2v/99PR2/DPR0500499_L1.htm,http://www3.registraduria.gov.co/elecciones/elecciones2014/presidente/2v/99PR2/DPR0599999_L1.htm,53,53,15286,7260,7153,45,7198,32,30,1925,26.74,5228,72.63
ALTOS DEL ROSARIO,BOLIVAR,http://www3.registraduria.gov.co/elecciones/elecciones2014/presidente/2v/99PR2/DPR0500699_L1.htm,http://www3.registraduria.gov.co/elecciones/elecciones2014/presidente/2v/99PR2/DPR0599999_L1.htm,19,19,6207,2766,2724,13,2737,15,14,1684,61.52,1040,37.99
ARENAL,BOLIVAR,http://www3.registraduria.gov.co/elecciones/elecciones2014/presidente/2v/99PR2/DPR0500599_L1.htm,http://www3.registraduria.gov.co/elecciones/elecciones2014/presidente/2v/99PR2/DPR0599999_L1.htm,15,15,5302,2184,2140,22,2162,20,2,1500,69.38,640,29.60
ARJONA,BOLIVAR,http://www3.registraduria.gov.co/elecciones/elecciones2014/presidente/2v/99PR2/DPR0500799_L1.htm,http://www3.registraduria.gov.co/elecciones/elecciones2014/presidente/2v/99PR2/DPR0599999_L1.htm,118,118,48396,18576,17747,514,18261,259,56,11673,63.92,6074,33.26
ARROYO HONDO,BOLIVAR,http://www3.registraduria.gov.co/elecciones/elecciones2014/presidente/2v/99PR2/DPR0500999_L1.htm,http://www3.registraduria.gov.co/elecciones/elecciones2014/presidente/2v/99PR2/DPR0599999_L1.htm,20,20,6550,2652,2602,10,2612,31,9,1262,48.31,1340,51.30
BARRANCO DE LOBA,BOLIVAR,http://www3.registraduria.gov.co/elecciones/elecciones2014/presidente/2v/99PR2/DPR0501099_L1.htm,http://www3.registraduria.gov.co/elecciones/elecciones2014/presidente/2v/99PR2/DPR0599999_L1.htm,31,31,10513,4616,4508,22,4530,70,16,1731,38.21,2777,61.30
CALAMAR,BOLIVAR,http://www3.registraduria.gov.co/elecciones/elecciones2014/presidente/2v/99PR2/DPR0501399_L1.htm,http://www3.registraduria.gov.co/elecciones/elecciones2014/presidente/2v/99PR2/DPR0599999_L1.htm,46,46,16955,7695,7454,91,7545,118,32,4434,58.76,3020,40.02
CANTAGALLO,BOLIVAR,http://www3.registraduria.gov.co/elecciones/elecciones2014/presidente/2v/99PR2/DPR0501499_L1.htm,http://www3.registraduria.gov.co/elecciones/elecciones2014/presidente/2v/99PR2/DPR0599999_L1.htm,17,17,5946,2753,2693,40,2733,15,5,2015,73.72,678,24.80
CARTAGENA,BOLIVAR,http://www3.registraduria.gov.co/elecciones/elecciones2014/presidente/2v/99PR2/DPR0500199_L1.htm,http://www3.registraduria.gov.co/elecciones/elecciones2014/presidente/2v/99PR2/DPR0599999_L1.htm,1739,1739,692257,221386,210874,7749,218623,2414,349,120322,55.03,90552,41.41
CICUCO,BOLIVAR,http://www3.registraduria.gov.co/elecciones/elecciones2014/presidente/2v/99PR2/DPR0501599_L1.htm,http://www3.registraduria.gov.co/elecciones/elecciones2014/presidente/2v/99PR2/DPR0599999_L1.htm,26,26,8744,4531,4473,26,4499,24,8,3422,76.06,1051,23.36
CLEMENCIA,BOLIVAR,http://www3.registraduria.gov.co/elecciones/elecciones2014/presidente/2v/99PR2/DPR0501899_L1.htm,http://www3.registraduria.gov.co/elecciones/elecciones2014/presidente/2v/99PR2/DPR0599999_L1.htm,25,25,9561,4273,4167,55,4222,47,4,2975,70.46,1192,28.23
CORDOBA,BOLIVAR,http://www3.registraduria.gov.co/elecciones/elecciones2014/presidente/2v/99PR2/DPR0501699_L1.htm,http://www3.registraduria.gov.co/elecciones/elecciones2014/presidente/2v/99PR2/DPR0599999_L1.htm,37,37,12934,7021,6936,38,6974,29,18,4623,66.28,2313,33.16
EL CARMEN DE BOLIVAR,BOLIVAR,http://www3.registraduria.gov.co/elecciones/elecciones2014/presidente/2v/99PR2/DPR0502299_L1.htm,http://www3.registraduria.gov.co/elecciones/elecciones2014/presidente/2v/99PR2/DPR0599999_L1.htm,133,133,50793,23898,23291,242,23533,275,90,11625,49.39,11666,49.57
EL GUAMO,BOLIVAR,http://www3.registraduria.gov.co/elecciones/elecciones2014/presidente/2v/99PR2/DPR0502599_L1.htm,http://www3.registraduria.gov.co/elecciones/elecciones2014/presidente/2v/99PR2/DPR0599999_L1.htm,20,20,7055,3165,3117,18,3135,15,15,2138,68.19,979,31.22
EL PEÑON,BOLIVAR,http://www3.registraduria.gov.co/elecciones/elecciones2014/presidente/2v/99PR2/DPR0502799_L1.htm,http://www3.registraduria.gov.co/elecciones/elecciones2014/presidente/2v/99PR2/DPR0599999_L1.htm,18,18,5485,2566,2527,15,2542,21,3,1315,51.73,1212,47.67
HATILLO DE LOBA,BOLIVAR,http://www3.registraduria.gov.co/elecciones/elecciones2014/presidente/2v/99PR2/DPR0502699_L1.htm,http://www3.registraduria.gov.co/elecciones/elecciones2014/presidente/2v/99PR2/DPR0599999_L1.htm,29,29,9615,4238,4163,16,4179,47,12,2047,48.98,2116,50.63
MAGANGUE,BOLIVAR,http://www3.registraduria.gov.co/elecciones/elecciones2014/presidente/2v/99PR2/DPR0502899_L1.htm,http://www3.registraduria.gov.co/elecciones/elecciones2014/presidente/2v/99PR2/DPR0599999_L1.htm,240,240,89302,39334,38473,389,38862,398,74,25871,66.57,12602,32.42
MAHATES,BOLIVAR,http://www3.registraduria.gov.co/elecciones/elecciones2014/presidente/2v/99PR2/DPR0503199_L1.htm,http://www3.registraduria.gov.co/elecciones/elecciones2014/presidente/2v/99PR2/DPR0599999_L1.htm,50,50,18621,7455,7304,62,7366,72,17,4139,56.19,3165,42.96
MARGARITA,BOLIVAR,http://www3.registraduria.gov.co/elecciones/elecciones2014/presidente/2v/99PR2/DPR0503799_L1.htm,http://www3.registraduria.gov.co/elecciones/elecciones2014/presidente/2v/99PR2/DPR0599999_L1.htm,26,26,8460,3532,3489,19,3508,17,7,1941,55.33,1548,44.12
MARIA LA BAJA,BOLIVAR,http://www3.registraduria.gov.co/elecciones/elecciones2014/presidente/2v/99PR2/DPR0504099_L1.htm,http://www3.registraduria.gov.co/elecciones/elecciones2014/presidente/2v/99PR2/DPR0599999_L1.htm,99,99,35962,15006,14743,100,14843,123,40,11608,78.20,3135,21.12
MOMPOS,BOLIVAR,http://www3.registraduria.gov.co/elecciones/elecciones2014/presidente/2v/99PR2/DPR0504399_L1.htm,http://www3.registraduria.gov.co/elecciones/elecciones2014/presidente/2v/99PR2/DPR0599999_L1.htm,98,98,33608,13668,13344,144,13488,157,23,8701,64.50,4643,34.42
MONTECRISTO,BOLIVAR,http://www3.registraduria.gov.co/elecciones/elecciones2014/presidente/2v/99PR2/DPR0504199_L1.htm,http://www3.registraduria.gov.co/elecciones/elecciones2014/presidente/2v/99PR2/DPR0599999_L1.htm,28,28,8384,2804,2722,32,2754,43,7,1567,56.89,1155,41.93
MORALES,BOLIVAR,http://www3.registraduria.gov.co/elecciones/elecciones2014/presidente/2v/99PR2/DPR0504499_L1.htm,http://www3.registraduria.gov.co/elecciones/elecciones2014/presidente/2v/99PR2/DPR0599999_L1.htm,31,31,10311,5096,4962,68,5030,51,15,2554,50.77,2408,47.87
NOROSI,BOLIVAR,http://www3.registraduria.gov.co/elecciones/elecciones2014/presidente/2v/99PR2/DPR0505099_L1.htm,http://www3.registraduria.gov.co/elecciones/elecciones2014/presidente/2v/99PR2/DPR0599999_L1.htm,12,12,3615,1563,1533,14,1547,15,1,1019,65.86,514,33.22
PINILLOS,BOLIVAR,http://www3.registraduria.gov.co/elecciones/elecciones2014/presidente/2v/99PR2/DPR0505999_L1.htm,http://www3.registraduria.gov.co/elecciones/elecciones2014/presidente/2v/99PR2/DPR0599999_L1.htm,52,52,15566,6826,6685,45,6730,76,20,3661,54.39,3024,44.93
REGIDOR,BOLIVAR,http://www3.registraduria.gov.co/elecciones/elecciones2014/presidente/2v/99PR2/DPR0506399_L1.htm,http://www3.registraduria.gov.co/elecciones/elecciones2014/presidente/2v/99PR2/DPR0599999_L1.htm,14,14,4284,2255,2224,10,2234,17,4,1524,68.21,700,31.33
RIOVIEJO,BOLIVAR,http://www3.registraduria.gov.co/elecciones/elecciones2014/presidente/2v/99PR2/DPR0506599_L1.htm,http://www3.registraduria.gov.co/elecciones/elecciones2014/presidente/2v/99PR2/DPR0599999_L1.htm,16,16,5683,2877,2810,33,2843,28,6,1593,56.03,1217,42.80
SAN CRISTOBAL,BOLIVAR,http://www3.registraduria.gov.co/elecciones/elecciones2014/presidente/2v/99PR2/DPR0507299_L1.htm,http://www3.registraduria.gov.co/elecciones/elecciones2014/presidente/2v/99PR2/DPR0599999_L1.htm,16,16,6053,3007,2971,14,2985,21,1,2468,82.68,503,16.85
SAN ESTANISLAO,BOLIVAR,http://www3.registraduria.gov.co/elecciones/elecciones2014/presidente/2v/99PR2/DPR0507099_L1.htm,http://www3.registraduria.gov.co/elecciones/elecciones2014/presidente/2v/99PR2/DPR0599999_L1.htm,36,36,13563,6201,6073,59,6132,55,14,4234,69.04,1839,29.99
SAN FERNANDO,BOLIVAR,http://www3.registraduria.gov.co/elecciones/elecciones2014/presidente/2v/99PR2/DPR0507399_L1.htm,http://www3.registraduria.gov.co/elecciones/elecciones2014/presidente/2v/99PR2/DPR0599999_L1.htm,25,25,7833,2974,2921,18,2939,29,6,2082,70.84,839,28.54
SAN JACINTO,BOLIVAR,http://www3.registraduria.gov.co/elecciones/elecciones2014/presidente/2v/99PR2/DPR0507699_L1.htm,http://www3.registraduria.gov.co/elecciones/elecciones2014/presidente/2v/99PR2/DPR0599999_L1.htm,55,55,19368,10497,10262,100,10362,94,41,5776,55.74,4486,43.29
SAN JACINTO DEL CAUCA,BOLIVAR,http://www3.registraduria.gov.co/elecciones/elecciones2014/presidente/2v/99PR2/DPR0507899_L1.htm,http://www3.registraduria.gov.co/elecciones/elecciones2014/presidente/2v/99PR2/DPR0599999_L1.htm,22,22,6563,3202,3105,24,3129,61,12,1584,50.62,1521,48.60
SAN JUAN NEPOMUCENO,BOLIVAR,http://www3.registraduria.gov.co/elecciones/elecciones2014/presidente/2v/99PR2/DPR0507999_L1.htm,http://www3.registraduria.gov.co/elecciones/elecciones2014/presidente/2v/99PR2/DPR0599999_L1.htm,78,78,29049,12990,12680,136,12816,147,27,6831,53.30,5849,45.63
SAN MARTIN DE LOBA,BOLIVAR,http://www3.registraduria.gov.co/elecciones/elecciones2014/presidente/2v/99PR2/DPR0508299_L1.htm,http://www3.registraduria.gov.co/elecciones/elecciones2014/presidente/2v/99PR2/DPR0599999_L1.htm,28,28,10366,4357,4258,40,4298,47,12,2194,51.04,2064,48.02
SAN PABLO,BOLIVAR,http://www3.registraduria.gov.co/elecciones/elecciones2014/presidente/2v/99PR2/DPR0508499_L1.htm,http://www3.registraduria.gov.co/elecciones/elecciones2014/presidente/2v/99PR2/DPR0599999_L1.htm,47,47,16328,7258,7022,125,7147,84,27,4486,62.76,2536,35.48
SANTA CATALINA,BOLIVAR,http://www3.registraduria.gov.co/elecciones/elecciones2014/presidente/2v/99PR2/DPR0509199_L1.htm,http://www3.registraduria.gov.co/elecciones/elecciones2014/presidente/2v/99PR2/DPR0599999_L1.htm,31,31,11136,4854,4760,52,4812,33,9,3988,82.87,772,16.04
SANTA ROSA,BOLIVAR,http://www3.registraduria.gov.co/elecciones/elecciones2014/presidente/2v/99PR2/DPR0509499_L1.htm,http://www3.registraduria.gov.co/elecciones/elecciones2014/presidente/2v/99PR2/DPR0599999_L1.htm,32,32,12294,4392,4279,67,4346,38,8,2839,65.32,1440,33.13
SANTA ROSA DEL SUR,BOLIVAR,http://www3.registraduria.gov.co/elecciones/elecciones2014/presidente/2v/99PR2/DPR0509599_L1.htm,http://www3.registraduria.gov.co/elecciones/elecciones2014/presidente/2v/99PR2/DPR0599999_L1.htm,49,49,16803,7865,7429,292,7721,114,30,2534,32.81,4895,63.39
SIMITI,BOLIVAR,http://www3.registraduria.gov.co/elecciones/elecciones2014/presidente/2v/99PR2/DPR0509799_L1.htm,http://www3.registraduria.gov.co/elecciones/elecciones2014/presidente/2v/99PR2/DPR0599999_L1.htm,37,37,11814,4980,4803,97,4900,54,26,2385,48.67,2418,49.34
SOPLAVIENTO,BOLIVAR,http://www3.registraduria.gov.co/elecciones/elecciones2014/presidente/2v/99PR2/DPR0510699_L1.htm,http://www3.registraduria.gov.co/elecciones/elecciones2014/presidente/2v/99PR2/DPR0599999_L1.htm,20,20,7765,4214,4159,34,4193,18,3,3686,87.90,473,11.28
TALAIGUA NUEVO,BOLIVAR,http://www3.registraduria.gov.co/elecciones/elecciones2014/presidente/2v/99PR2/DPR0511099_L1.htm,http://www3.registraduria.gov.co/elecciones/elecciones2014/presidente/2v/99PR2/DPR0599999_L1.htm,26,26,8649,4339,4263,38,4301,28,10,2534,58.91,1729,40.19
TIQUISIO (PTO. RICO),BOLIVAR,http://www3.registraduria.gov.co/elecciones/elecciones2014/presidente/2v/99PR2/DPR0511399_L1.htm,http://www3.registraduria.gov.co/elecciones/elecciones2014/presidente/2v/99PR2/DPR0599999_L1.htm,35,35,11548,4768,4668,33,4701,58,9,2135,45.41,2533,53.88
TURBACO,BOLIVAR,http://www3.registraduria.gov.co/elecciones/elecciones2014/presidente/2v/99PR2/DPR0511899_L1.htm,http://www3.registraduria.gov.co/elecciones/elecciones2014/presidente/2v/99PR2/DPR0599999_L1.htm,125,125,55375,18231,17298,619,17917,260,54,10900,60.83,6398,35.70
TURBANA,BOLIVAR,http://www3.registraduria.gov.co/elecciones/elecciones2014/presidente/2v/99PR2/DPR0512199_L1.htm,http://www3.registraduria.gov.co/elecciones/elecciones2014/presidente/2v/99PR2/DPR0599999_L1.htm,37,37,13563,5946,5752,106,5858,71,17,3485,59.49,2267,38.69
VILLANUEVA,BOLIVAR,http://www3.registraduria.gov.co/elecciones/elecciones2014/presidente/2v/99PR2/DPR0512499_L1.htm,http://www3.registraduria.gov.co/elecciones/elecciones2014/presidente/2v/99PR2/DPR0599999_L1.htm,38,38,14210,6668,6454,80,6534,122,12,2873,43.97,3581,54.80
ZAMBRANO,BOLIVAR,http://www3.registraduria.gov.co/elecciones/elecciones2014/presidente/2v/99PR2/DPR0512799_L1.htm,http://www3.registraduria.gov.co/elecciones/elecciones2014/presidente/2v/99PR2/DPR0599999_L1.htm,23,23,8536,4769,4688,23,4711,35,23,4165,88.41,523,11.10
ALMEIDA,BOYACA,http://www3.registraduria.gov.co/elecciones/elecciones2014/presidente/2v/99PR2/DPR0700799_L1.htm,http://www3.registraduria.gov.co/elecciones/elecciones2014/presidente/2v/99PR2/DPR0799999_L1.htm,5,5,1867,845,806,15,821,18,6,241,29.35,565,68.81
AQUITANIA (PUEBLOVIEJO),BOYACA,http://www3.registraduria.gov.co/elecciones/elecciones2014/presidente/2v/99PR2/DPR0700899_L1.htm,http://www3.registraduria.gov.co/elecciones/elecciones2014/presidente/2v/99PR2/DPR0799999_L1.htm,38,38,12252,6932,6639,118,6757,139,36,859,12.71,5780,85.54
ARCABUCO,BOYACA,http://www3.registraduria.gov.co/elecciones/elecciones2014/presidente/2v/99PR2/DPR0701099_L1.htm,http://www3.registraduria.gov.co/elecciones/elecciones2014/presidente/2v/99PR2/DPR0799999_L1.htm,12,12,4415,2406,2206,109,2315,76,15,975,42.11,1231,53.17
BELEN,BOYACA,http://www3.registraduria.gov.co/elecciones/elecciones2014/presidente/2v/99PR2/DPR0701399_L1.htm,http://www3.registraduria.gov.co/elecciones/elecciones2014/presidente/2v/99PR2/DPR0799999_L1.htm,18,18,6658,3709,3398,142,3540,150,19,1152,32.54,2246,63.44
BERBEO,BOYACA,http://www3.registraduria.gov.co/elecciones/elecciones2014/presidente/2v/99PR2/DPR0701699_L1.htm,http://www3.registraduria.gov.co/elecciones/elecciones2014/presidente/2v/99PR2/DPR0799999_L1.htm,4,4,1466,687,635,35,670,16,1,286,42.68,349,52.08
BETEITIVA,BOYACA,http://www3.registraduria.gov.co/elecciones/elecciones2014/presidente/2v/99PR2/DPR0701999_L1.htm,http://www3.registraduria.gov.co/elecciones/elecciones2014/presidente/2v/99PR2/DPR0799999_L1.htm,5,5,1884,974,906,42,948,22,4,464,48.94,442,46.62
BOAVITA,BOYACA,http://www3.registraduria.gov.co/elecciones/elecciones2014/presidente/2v/99PR2/DPR0702299_L1.htm,http://www3.registraduria.gov.co/elecciones/elecciones2014/presidente/2v/99PR2/DPR0799999_L1.htm,15,15,5150,2445,2348,51,2399,40,6,656,27.34,1692,70.52
BOYACA,BOYACA,http://www3.registraduria.gov.co/elecciones/elecciones2014/presidente/2v/99PR2/DPR0702599_L1.htm,http://www3.registraduria.gov.co/elecciones/elecciones2014/presidente/2v/99PR2/DPR0799999_L1.htm,11,11,4001,2089,1942,43,1985,75,29,660,33.24,1282,64.58
BRICEÑO,BOYACA,http://www3.registraduria.gov.co/elecciones/elecciones2014/presidente/2v/99PR2/DPR0702899_L1.htm,http://www3.registraduria.gov.co/elecciones/elecciones2014/presidente/2v/99PR2/DPR0799999_L1.htm,6,6,1977,1075,1032,27,1059,11,5,339,32.01,693,65.43
BUENAVISTA,BOYACA,http://www3.registraduria.gov.co/elecciones/elecciones2014/presidente/2v/99PR2/DPR0703199_L1.htm,http://www3.registraduria.gov.co/elecciones/elecciones2014/presidente/2v/99PR2/DPR0799999_L1.htm,14,14,4503,2447,2345,36,2381,44,22,809,33.97,1536,64.51
BUSBANZA,BOYACA,http://www3.registraduria.gov.co/elecciones/elecciones2014/presidente/2v/99PR2/DPR0703499_L1.htm,http://www3.registraduria.gov.co/elecciones/elecciones2014/presidente/2v/99PR2/DPR0799999_L1.htm,2,2,763,406,369,21,390,11,5,122,31.28,247,63.33
CALDAS,BOYACA,http://www3.registraduria.gov.co/elecciones/elecciones2014/presidente/2v/99PR2/DPR0703799_L1.htm,http://www3.registraduria.gov.co/elecciones/elecciones2014/presidente/2v/99PR2/DPR0799999_L1.htm,10,10,3072,1639,1552,50,1602,31,6,617,38.51,935,58.36
CAMPOHERMOSO,BOYACA,http://www3.registraduria.gov.co/elecciones/elecciones2014/presidente/2v/99PR2/DPR0704099_L1.htm,http://www3.registraduria.gov.co/elecciones/elecciones2014/presidente/2v/99PR2/DPR0799999_L1.htm,8,8,2502,1339,1287,43,1330,8,1,442,33.23,845,63.53
CERINZA,BOYACA,http://www3.registraduria.gov.co/elecciones/elecciones2014/presidente/2v/99PR2/DPR0704399_L1.htm,http://www3.registraduria.gov.co/elecciones/elecciones2014/presidente/2v/99PR2/DPR0799999_L1.htm,9,9,3303,1815,1622,94,1716,93,6,577,33.62,1045,60.89
CHINAVITA,BOYACA,http://www3.registraduria.gov.co/elecciones/elecciones2014/presidente/2v/99PR2/DPR0706499_L1.htm,http://www3.registraduria.gov.co/elecciones/elecciones2014/presidente/2v/99PR2/DPR0799999_L1.htm,9,9,3101,1562,1513,24,1537,22,3,455,29.60,1058,68.83
CHIQUINQUIRA,BOYACA,http://www3.registraduria.gov.co/elecciones/elecciones2014/presidente/2v/99PR2/DPR0706799_L1.htm,http://www3.registraduria.gov.co/elecciones/elecciones2014/presidente/2v/99PR2/DPR0799999_L1.htm,105,105,38741,20939,19277,923,20200,701,38,8694,43.03,10583,52.39
CHIQUIZA,BOYACA,http://www3.registraduria.gov.co/elecciones/elecciones2014/presidente/2v/99PR2/DPR0706899_L1.htm,http://www3.registraduria.gov.co/elecciones/elecciones2014/presidente/2v/99PR2/DPR0799999_L1.htm,12,12,4236,2411,2214,49,2263,138,10,1430,63.19,784,34.64
CHISCAS,BOYACA,http://www3.registraduria.gov.co/elecciones/elecciones2014/presidente/2v/99PR2/DPR0707099_L1.htm,http://www3.registraduria.gov.co/elecciones/elecciones2014/presidente/2v/99PR2/DPR0799999_L1.htm,11,11,3542,1824,1775,24,1799,22,3,380,21.12,1395,77.54
CHITA,BOYACA,http://www3.registraduria.gov.co/elecciones/elecciones2014/presidente/2v/99PR2/DPR0707399_L1.htm,http://www3.registraduria.gov.co/elecciones/elecciones2014/presidente/2v/99PR2/DPR0799999_L1.htm,22,22,6430,3226,3118,42,3160,41,25,374,11.83,2744,86.83
CHITARAQUE,BOYACA,http://www3.registraduria.gov.co/elecciones/elecciones2014/presidente/2v/99PR2/DPR0707699_L1.htm,http://www3.registraduria.gov.co/elecciones/elecciones2014/presidente/2v/99PR2/DPR0799999_L1.htm,15,15,5240,2439,2342,42,2384,42,13,920,38.59,1422,59.64
CHIVATA,BOYACA,http://www3.registraduria.gov.co/elecciones/elecciones2014/presidente/2v/99PR2/DPR0707799_L1.htm,http://www3.registraduria.gov.co/elecciones/elecciones2014/presidente/2v/99PR2/DPR0799999_L1.htm,7,7,2545,1494,1421,23,1444,46,4,687,47.57,734,50.83
CHIVOR,BOYACA,http://www3.registraduria.gov.co/elecciones/elecciones2014/presidente/2v/99PR2/DPR0707899_L1.htm,http://www3.registraduria.gov.co/elecciones/elecciones2014/presidente/2v/99PR2/DPR0799999_L1.htm,6,6,1778,937,901,15,916,20,1,261,28.49,640,69.86
CIENEGA,BOYACA,http://www3.registraduria.gov.co/elecciones/elecciones2014/presidente/2v/99PR2/DPR0704699_L1.htm,http://www3.registraduria.gov.co/elecciones/elecciones2014/presidente/2v/99PR2/DPR0799999_L1.htm,10,10,3757,2242,2162,48,2210,25,7,326,14.75,1836,83.07
COMBITA,BOYACA,http://www3.registraduria.gov.co/elecciones/elecciones2014/presidente/2v/99PR2/DPR0704999_L1.htm,http://www3.registraduria.gov.co/elecciones/elecciones2014/presidente/2v/99PR2/DPR0799999_L1.htm,24,24,8320,4241,3919,134,4053,171,17,1838,45.34,2081,51.34
COPER,BOYACA,http://www3.registraduria.gov.co/elecciones/elecciones2014/presidente/2v/99PR2/DPR0705299_L1.htm,http://www3.registraduria.gov.co/elecciones/elecciones2014/presidente/2v/99PR2/DPR0799999_L1.htm,11,11,3240,1680,1634,24,1658,17,5,878,52.95,756,45.59
CORRALES,BOYACA,http://www3.registraduria.gov.co/elecciones/elecciones2014/presidente/2v/99PR2/DPR0705599_L1.htm,http://www3.registraduria.gov.co/elecciones/elecciones2014/presidente/2v/99PR2/DPR0799999_L1.htm,6,6,2170,1289,1165,51,1216,70,3,427,35.11,738,60.69
COVARACHIA,BOYACA,http://www3.registraduria.gov.co/elecciones/elecciones2014/presidente/2v/99PR2/DPR0705899_L1.htm,http://www3.registraduria.gov.co/elecciones/elecciones2014/presidente/2v/99PR2/DPR0799999_L1.htm,10,10,3177,1470,1417,18,1435,24,11,220,15.33,1197,83.41
CUBARA,BOYACA,http://www3.registraduria.gov.co/elecciones/elecciones2014/presidente/2v/99PR2/DPR0705999_L1.htm,http://www3.registraduria.gov.co/elecciones/elecciones2014/presidente/2v/99PR2/DPR0799999_L1.htm,15,15,4575,1812,1665,72,1737,59,16,1002,57.68,663,38.16
CUCAITA,BOYACA,http://www3.registraduria.gov.co/elecciones/elecciones2014/presidente/2v/99PR2/DPR0706099_L1.htm,http://www3.registraduria.gov.co/elecciones/elecciones2014/presidente/2v/99PR2/DPR0799999_L1.htm,8,8,2988,1868,1757,68,1825,39,4,695,38.08,1062,58.19
CUITIVA,BOYACA,http://www3.registraduria.gov.co/elecciones/elecciones2014/presidente/2v/99PR2/DPR0706199_L1.htm,http://www3.registraduria.gov.co/elecciones/elecciones2014/presidente/2v/99PR2/DPR0799999_L1.htm,6,6,1870,1091,1048,19,1067,23,1,317,29.70,731,68.50
DUITAMA,BOYACA,http://www3.registraduria.gov.co/elecciones/elecciones2014/presidente/2v/99PR2/DPR0707999_L1.htm,http://www3.registraduria.gov.co/elecciones/elecciones2014/presidente/2v/99PR2/DPR0799999_L1.htm,201,201,79112,45913,41131,2449,43580,2265,68,18391,42.20,22740,52.17
EL COCUY,BOYACA,http://www3.registraduria.gov.co/elecciones/elecciones2014/presidente/2v/99PR2/DPR0708299_L1.htm,http://www3.registraduria.gov.co/elecciones/elecciones2014/presidente/2v/99PR2/DPR0799999_L1.htm,11,11,3711,2033,1910,83,1993,36,4,222,11.13,1688,84.69
EL ESPINO,BOYACA,http://www3.registraduria.gov.co/elecciones/elecciones2014/presidente/2v/99PR2/DPR0708599_L1.htm,http://www3.registraduria.gov.co/elecciones/elecciones2014/presidente/2v/99PR2/DPR0799999_L1.htm,7,7,2244,1300,1271,15,1286,8,6,128,9.95,1143,88.88
FIRAVITOBA,BOYACA,http://www3.registraduria.gov.co/elecciones/elecciones2014/presidente/2v/99PR2/DPR0708899_L1.htm,http://www3.registraduria.gov.co/elecciones/elecciones2014/presidente/2v/99PR2/DPR0799999_L1.htm,16,16,5540,2565,2358,99,2457,98,10,1192,48.51,1166,47.45
FLORESTA,BOYACA,http://www3.registraduria.gov.co/elecciones/elecciones2014/presidente/2v/99PR2/DPR0709199_L1.htm,http://www3.registraduria.gov.co/elecciones/elecciones2014/presidente/2v/99PR2/DPR0799999_L1.htm,9,9,3045,1692,1595,51,1646,40,6,425,25.82,1170,71.08
GACHANTIVA,BOYACA,http://www3.registraduria.gov.co/elecciones/elecciones2014/presidente/2v/99PR2/DPR0709499_L1.htm,http://www3.registraduria.gov.co/elecciones/elecciones2014/presidente/2v/99PR2/DPR0799999_L1.htm,8,8,2766,1578,1507,30,1537,32,9,594,38.64,913,59.40
GAMEZA,BOYACA,http://www3.registraduria.gov.co/elecciones/elecciones2014/presidente/2v/99PR2/DPR0709799_L1.htm,http://www3.registraduria.gov.co/elecciones/elecciones2014/presidente/2v/99PR2/DPR0799999_L1.htm,11,11,4044,2051,1951,33,1984,59,8,456,22.98,1495,75.35
GARAGOA,BOYACA,http://www3.registraduria.gov.co/elecciones/elecciones2014/presidente/2v/99PR2/DPR0710099_L1.htm,http://www3.registraduria.gov.co/elecciones/elecciones2014/presidente/2v/99PR2/DPR0799999_L1.htm,32,32,11535,6166,5777,207,5984,169,13,2386,39.87,3391,56.66
GUACAMAYAS,BOYACA,http://www3.registraduria.gov.co/elecciones/elecciones2014/presidente/2v/99PR2/DPR0710399_L1.htm,http://www3.registraduria.gov.co/elecciones/elecciones2014/presidente/2v/99PR2/DPR0799999_L1.htm,5,5,1642,920,886,20,906,11,3,83,9.16,803,88.63
GUATEQUE,BOYACA,http://www3.registraduria.gov.co/elecciones/elecciones2014/presidente/2v/99PR2/DPR0710699_L1.htm,http://www3.registraduria.gov.co/elecciones/elecciones2014/presidente/2v/99PR2/DPR0799999_L1.htm,24,24,8798,4313,4019,146,4165,131,17,1906,45.76,2113,50.73
GUAYATA,BOYACA,http://www3.registraduria.gov.co/elecciones/elecciones2014/presidente/2v/99PR2/DPR0710999_L1.htm,http://www3.registraduria.gov.co/elecciones/elecciones2014/presidente/2v/99PR2/DPR0799999_L1.htm,10,10,3876,2032,1956,43,1999,25,8,469,23.46,1487,74.38
GUICAN,BOYACA,http://www3.registraduria.gov.co/elecciones/elecciones2014/presidente/2v/99PR2/DPR0711299_L1.htm,http://www3.registraduria.gov.co/elecciones/elecciones2014/presidente/2v/99PR2/DPR0799999_L1.htm,11,11,2992,1667,1587,44,1631,24,12,288,17.65,1299,79.64
IZA,BOYACA,http://www3.registraduria.gov.co/elecciones/elecciones2014/presidente/2v/99PR2/DPR0711899_L1.htm,http://www3.registraduria.gov.co/elecciones/elecciones2014/presidente/2v/99PR2/DPR0799999_L1.htm,6,6,2115,1075,1015,35,1050,24,1,374,35.61,641,61.04
JENESANO,BOYACA,http://www3.registraduria.gov.co/elecciones/elecciones2014/presidente/2v/99PR2/DPR0712199_L1.htm,http://www3.registraduria.gov.co/elecciones/elecciones2014/presidente/2v/99PR2/DPR0799999_L1.htm,14,14,5296,2764,2629,55,2684,71,9,1007,37.51,1622,60.43
JERICO,BOYACA,http://www3.registraduria.gov.co/elecciones/elecciones2014/presidente/2v/99PR2/DPR0712499_L1.htm,http://www3.registraduria.gov.co/elecciones/elecciones2014/presidente/2v/99PR2/DPR0799999_L1.htm,9,9,3094,1639,1589,22,1611,22,6,228,14.15,1361,84.48
LA CAPILLA,BOYACA,http://www3.registraduria.gov.co/elecciones/elecciones2014/presidente/2v/99PR2/DPR0713099_L1.htm,http://www3.registraduria.gov.co/elecciones/elecciones2014/presidente/2v/99PR2/DPR0799999_L1.htm,7,7,2574,1354,1288,36,1324,27,3,433,32.70,855,64.57
LA UVITA,BOYACA,http://www3.registraduria.gov.co/elecciones/elecciones2014/presidente/2v/99PR2/DPR0713699_L1.htm,http://www3.registraduria.gov.co/elecciones/elecciones2014/presidente/2v/99PR2/DPR0799999_L1.htm,8,8,2512,1348,1294,21,1315,24,9,238,18.09,1056,80.30
LA VICTORIA,BOYACA,http://www3.registraduria.gov.co/elecciones/elecciones2014/presidente/2v/99PR2/DPR0713799_L1.htm,http://www3.registraduria.gov.co/elecciones/elecciones2014/presidente/2v/99PR2/DPR0799999_L1.htm,6,6,1478,761,736,14,750,9,2,384,51.20,352,46.93
LABRANZAGRANDE,BOYACA,http://www3.registraduria.gov.co/elecciones/elecciones2014/presidente/2v/99PR2/DPR0712799_L1.htm,http://www3.registraduria.gov.co/elecciones/elecciones2014/presidente/2v/99PR2/DPR0799999_L1.htm,8,8,2670,1506,1454,22,1476,20,10,204,13.82,1250,84.68
MACANAL,BOYACA,http://www3.registraduria.gov.co/elecciones/elecciones2014/presidente/2v/99PR2/DPR0714299_L1.htm,http://www3.registraduria.gov.co/elecciones/elecciones2014/presidente/2v/99PR2/DPR0799999_L1.htm,10,10,3533,1844,1777,30,1807,32,5,571,31.59,1206,66.74
MARIPI,BOYACA,http://www3.registraduria.gov.co/elecciones/elecciones2014/presidente/2v/99PR2/DPR0714899_L1.htm,http://www3.registraduria.gov.co/elecciones/elecciones2014/presidente/2v/99PR2/DPR0799999_L1.htm,21,21,6561,2983,2919,28,2947,30,6,1296,43.97,1623,55.07
MIRAFLORES,BOYACA,http://www3.registraduria.gov.co/elecciones/elecciones2014/presidente/2v/99PR2/DPR0715199_L1.htm,http://www3.registraduria.gov.co/elecciones/elecciones2014/presidente/2v/99PR2/DPR0799999_L1.htm,20,20,7548,4307,3995,221,4216,78,13,2303,54.62,1692,40.13
MONGUA,BOYACA,http://www3.registraduria.gov.co/elecciones/elecciones2014/presidente/2v/99PR2/DPR0715499_L1.htm,http://www3.registraduria.gov.co/elecciones/elecciones2014/presidente/2v/99PR2/DPR0799999_L1.htm,11,11,3841,2461,2393,28,2421,36,4,257,10.61,2136,88.22
MONGUI,BOYACA,http://www3.registraduria.gov.co/elecciones/elecciones2014/presidente/2v/99PR2/DPR0715799_L1.htm,http://www3.registraduria.gov.co/elecciones/elecciones2014/presidente/2v/99PR2/DPR0799999_L1.htm,9,9,3436,1925,1812,63,1875,44,6,482,25.70,1330,70.93
MONIQUIRA,BOYACA,http://www3.registraduria.gov.co/elecciones/elecciones2014/presidente/2v/99PR2/DPR0716099_L1.htm,http://www3.registraduria.gov.co/elecciones/elecciones2014/presidente/2v/99PR2/DPR0799999_L1.htm,45,45,16776,8630,7985,273,8258,339,33,3547,42.95,4438,53.74
MOTAVITA,BOYACA,http://www3.registraduria.gov.co/elecciones/elecciones2014/presidente/2v/99PR2/DPR0716199_L1.htm,http://www3.registraduria.gov.co/elecciones/elecciones2014/presidente/2v/99PR2/DPR0799999_L1.htm,13,13,4759,2763,2566,76,2642,114,7,1327,50.22,1239,46.89
MUZO,BOYACA,http://www3.registraduria.gov.co/elecciones/elecciones2014/presidente/2v/99PR2/DPR0716399_L1.htm,http://www3.registraduria.gov.co/elecciones/elecciones2014/presidente/2v/99PR2/DPR0799999_L1.htm,18,18,6961,3381,3189,79,3268,80,33,955,29.22,2234,68.35
NOBSA,BOYACA,http://www3.registraduria.gov.co/elecciones/elecciones2014/presidente/2v/99PR2/DPR0716699_L1.htm,http://www3.registraduria.gov.co/elecciones/elecciones2014/presidente/2v/99PR2/DPR0799999_L1.htm,29,29,10901,6802,6165,293,6458,339,5,3442,53.29,2723,42.16
NUEVO COLON,BOYACA,http://www3.registraduria.gov.co/elecciones/elecciones2014/presidente/2v/99PR2/DPR0716999_L1.htm,http://www3.registraduria.gov.co/elecciones/elecciones2014/presidente/2v/99PR2/DPR0799999_L1.htm,12,12,4437,2359,2204,79,2283,65,11,763,33.42,1441,63.11
OICATA,BOYACA,http://www3.registraduria.gov.co/elecciones/elecciones2014/presidente/2v/99PR2/DPR0717399_L1.htm,http://www3.registraduria.gov.co/elecciones/elecciones2014/presidente/2v/99PR2/DPR0799999_L1.htm,6,6,2290,1261,1169,44,1213,46,2,534,44.02,635,52.34
OTANCHE,BOYACA,http://www3.registraduria.gov.co/elecciones/elecciones2014/presidente/2v/99PR2/DPR0717699_L1.htm,http://www3.registraduria.gov.co/elecciones/elecciones2014/presidente/2v/99PR2/DPR0799999_L1.htm,23,23,6353,3102,2952,70,3022,61,19,562,18.59,2390,79.08
PACHAVITA,BOYACA,http://www3.registraduria.gov.co/elecciones/elecciones2014/presidente/2v/99PR2/DPR0717899_L1.htm,http://www3.registraduria.gov.co/elecciones/elecciones2014/presidente/2v/99PR2/DPR0799999_L1.htm,6,6,1994,1156,1107,26,1133,19,4,311,27.44,796,70.25
PAEZ,BOYACA,http://www3.registraduria.gov.co/elecciones/elecciones2014/presidente/2v/99PR2/DPR0717999_L1.htm,http://www3.registraduria.gov.co/elecciones/elecciones2014/presidente/2v/99PR2/DPR0799999_L1.htm,7,7,2265,1465,1406,31,1437,23,5,625,43.49,781,54.34
PAIPA,BOYACA,http://www3.registraduria.gov.co/elecciones/elecciones2014/presidente/2v/99PR2/DPR0718199_L1.htm,http://www3.registraduria.gov.co/elecciones/elecciones2014/presidente/2v/99PR2/DPR0799999_L1.htm,63,63,23614,13512,12308,619,12927,555,30,5865,45.37,6443,49.84
PAJARITO,BOYACA,http://www3.registraduria.gov.co/elecciones/elecciones2014/presidente/2v/99PR2/DPR0718499_L1.htm,http://www3.registraduria.gov.co/elecciones/elecciones2014/presidente/2v/99PR2/DPR0799999_L1.htm,5,5,1612,889,852,18,870,12,7,191,21.95,661,75.97
PANQUEBA,BOYACA,http://www3.registraduria.gov.co/elecciones/elecciones2014/presidente/2v/99PR2/DPR0718799_L1.htm,http://www3.registraduria.gov.co/elecciones/elecciones2014/presidente/2v/99PR2/DPR0799999_L1.htm,4,4,1516,813,788,13,801,10,2,83,10.36,705,88.01
PAUNA,BOYACA,http://www3.registraduria.gov.co/elecciones/elecciones2014/presidente/2v/99PR2/DPR0719099_L1.htm,http://www3.registraduria.gov.co/elecciones/elecciones2014/presidente/2v/99PR2/DPR0799999_L1.htm,19,19,6759,3522,3366,67,3433,62,27,1130,32.91,2236,65.13
PAYA,BOYACA,http://www3.registraduria.gov.co/elecciones/elecciones2014/presidente/2v/99PR2/DPR0719399_L1.htm,http://www3.registraduria.gov.co/elecciones/elecciones2014/presidente/2v/99PR2/DPR0799999_L1.htm,5,5,1284,752,706,31,737,12,3,119,16.14,587,79.64
PAZ DE RIO,BOYACA,http://www3.registraduria.gov.co/elecciones/elecciones2014/presidente/2v/99PR2/DPR0719999_L1.htm,http://www3.registraduria.gov.co/elecciones/elecciones2014/presidente/2v/99PR2/DPR0799999_L1.htm,12,12,4418,2142,1970,83,2053,74,15,1335,65.02,635,30.93
PESCA,BOYACA,http://www3.registraduria.gov.co/elecciones/elecciones2014/presidente/2v/99PR2/DPR0720299_L1.htm,http://www3.registraduria.gov.co/elecciones/elecciones2014/presidente/2v/99PR2/DPR0799999_L1.htm,17,17,6147,3038,2880,69,2949,77,12,679,23.02,2201,74.63
PISBA,BOYACA,http://www3.registraduria.gov.co/elecciones/elecciones2014/presidente/2v/99PR2/DPR0720599_L1.htm,http://www3.registraduria.gov.co/elecciones/elecciones2014/presidente/2v/99PR2/DPR0799999_L1.htm,3,3,968,563,547,9,556,3,4,144,25.89,403,72.48
PUERTO BOYACA,BOYACA,http://www3.registraduria.gov.co/elecciones/elecciones2014/presidente/2v/99PR2/DPR0721499_L1.htm,http://www3.registraduria.gov.co/elecciones/elecciones2014/presidente/2v/99PR2/DPR0799999_L1.htm,86,86,31446,15152,13809,624,14433,633,86,6139,42.53,7670,53.14
QUIPAMA,BOYACA,http://www3.registraduria.gov.co/elecciones/elecciones2014/presidente/2v/99PR2/DPR0721599_L1.htm,http://www3.registraduria.gov.co/elecciones/elecciones2014/presidente/2v/99PR2/DPR0799999_L1.htm,15,15,4842,2357,2257,35,2292,40,25,525,22.90,1732,75.56
RAMIRIQUI,BOYACA,http://www3.registraduria.gov.co/elecciones/elecciones2014/presidente/2v/99PR2/DPR0721799_L1.htm,http://www3.registraduria.gov.co/elecciones/elecciones2014/presidente/2v/99PR2/DPR0799999_L1.htm,23,23,8433,4474,4249,127,4376,90,8,1639,37.45,2610,59.64
RAQUIRA,BOYACA,http://www3.registraduria.gov.co/elecciones/elecciones2014/presidente/2v/99PR2/DPR0722099_L1.htm,http://www3.registraduria.gov.co/elecciones/elecciones2014/presidente/2v/99PR2/DPR0799999_L1.htm,12,12,4405,2503,2310,112,2422,70,11,812,33.52,1498,61.84
RONDON,BOYACA,http://www3.registraduria.gov.co/elecciones/elecciones2014/presidente/2v/99PR2/DPR0722399_L1.htm,http://www3.registraduria.gov.co/elecciones/elecciones2014/presidente/2v/99PR2/DPR0799999_L1.htm,7,7,2246,1234,1171,36,1207,21,6,438,36.28,733,60.72
SABOYA,BOYACA,http://www3.registraduria.gov.co/elecciones/elecciones2014/presidente/2v/99PR2/DPR0722699_L1.htm,http://www3.registraduria.gov.co/elecciones/elecciones2014/presidente/2v/99PR2/DPR0799999_L1.htm,28,28,9419,5762,5403,165,5568,158,36,2130,38.25,3273,58.78
SACHICA,BOYACA,http://www3.registraduria.gov.co/elecciones/elecciones2014/presidente/2v/99PR2/DPR0723299_L1.htm,http://www3.registraduria.gov.co/elecciones/elecciones2014/presidente/2v/99PR2/DPR0799999_L1.htm,8,8,3126,2058,1913,60,1973,74,11,964,48.85,949,48.09
SAMACA,BOYACA,http://www3.registraduria.gov.co/elecciones/elecciones2014/presidente/2v/99PR2/DPR0723599_L1.htm,http://www3.registraduria.gov.co/elecciones/elecciones2014/presidente/2v/99PR2/DPR0799999_L1.htm,33,33,12663,7471,6873,279,7152,298,21,2787,38.96,4086,57.13
SAN EDUARDO,BOYACA,http://www3.registraduria.gov.co/elecciones/elecciones2014/presidente/2v/99PR2/DPR0723799_L1.htm,http://www3.registraduria.gov.co/elecciones/elecciones2014/presidente/2v/99PR2/DPR0799999_L1.htm,4,4,1423,799,734,51,785,12,2,252,32.10,482,61.40
SAN JOSE DE PARE,BOYACA,http://www3.registraduria.gov.co/elecciones/elecciones2014/presidente/2v/99PR2/DPR0723899_L1.htm,http://www3.registraduria.gov.co/elecciones/elecciones2014/presidente/2v/99PR2/DPR0799999_L1.htm,15,15,5155,2384,2268,52,2320,43,21,749,32.28,1519,65.47
SAN LUIS DE GACENO,BOYACA,http://www3.registraduria.gov.co/elecciones/elecciones2014/presidente/2v/99PR2/DPR0724199_L1.htm,http://www3.registraduria.gov.co/elecciones/elecciones2014/presidente/2v/99PR2/DPR0799999_L1.htm,14,14,4485,2435,2326,66,2392,30,13,526,21.98,1800,75.25
SAN MATEO,BOYACA,http://www3.registraduria.gov.co/elecciones/elecciones2014/presidente/2v/99PR2/DPR0724799_L1.htm,http://www3.registraduria.gov.co/elecciones/elecciones2014/presidente/2v/99PR2/DPR0799999_L1.htm,10,10,3708,1942,1877,36,1913,19,10,243,12.70,1634,85.41
SAN MIGUEL DE SEMA,BOYACA,http://www3.registraduria.gov.co/elecciones/elecciones2014/presidente/2v/99PR2/DPR0724899_L1.htm,http://www3.registraduria.gov.co/elecciones/elecciones2014/presidente/2v/99PR2/DPR0799999_L1.htm,7,7,2722,1450,1369,38,1407,37,6,486,34.54,883,62.75
SAN PABLO DE BORBUR,BOYACA,http://www3.registraduria.gov.co/elecciones/elecciones2014/presidente/2v/99PR2/DPR0724999_L1.htm,http://www3.registraduria.gov.co/elecciones/elecciones2014/presidente/2v/99PR2/DPR0799999_L1.htm,16,16,5775,2752,2638,38,2676,54,22,486,18.16,2152,80.41
SANTA MARIA,BOYACA,http://www3.registraduria.gov.co/elecciones/elecciones2014/presidente/2v/99PR2/DPR0725199_L1.htm,http://www3.registraduria.gov.co/elecciones/elecciones2014/presidente/2v/99PR2/DPR0799999_L1.htm,10,10,3377,1574,1408,91,1499,66,9,565,37.69,843,56.23
SANTA ROSA DE VITERBO,BOYACA,http://www3.registraduria.gov.co/elecciones/elecciones2014/presidente/2v/99PR2/DPR0725399_L1.htm,http://www3.registraduria.gov.co/elecciones/elecciones2014/presidente/2v/99PR2/DPR0799999_L1.htm,21,21,7720,4612,4251,193,4444,154,14,1443,32.47,2808,63.18
SANTA SOFIA,BOYACA,http://www3.registraduria.gov.co/elecciones/elecciones2014/presidente/2v/99PR2/DPR0725699_L1.htm,http://www3.registraduria.gov.co/elecciones/elecciones2014/presidente/2v/99PR2/DPR0799999_L1.htm,8,8,2960,1554,1458,48,1506,39,9,423,28.08,1035,68.72
SANTANA,BOYACA,http://www3.registraduria.gov.co/elecciones/elecciones2014/presidente/2v/99PR2/DPR0725099_L1.htm,http://www3.registraduria.gov.co/elecciones/elecciones2014/presidente/2v/99PR2/DPR0799999_L1.htm,17,17,6514,3196,3094,56,3150,34,12,1552,49.26,1542,48.95
SATIVANORTE,BOYACA,http://www3.registraduria.gov.co/elecciones/elecciones2014/presidente/2v/99PR2/DPR0725999_L1.htm,http://www3.registraduria.gov.co/elecciones/elecciones2014/presidente/2v/99PR2/DPR0799999_L1.htm,7,7,2368,1251,1216,18,1234,12,5,471,38.16,745,60.37
SATIVASUR,BOYACA,http://www3.registraduria.gov.co/elecciones/elecciones2014/presidente/2v/99PR2/DPR0726299_L1.htm,http://www3.registraduria.gov.co/elecciones/elecciones2014/presidente/2v/99PR2/DPR0799999_L1.htm,4,4,1228,641,601,18,619,17,5,275,44.42,326,52.66
SIACHOQUE,BOYACA,http://www3.registraduria.gov.co/elecciones/elecciones2014/presidente/2v/99PR2/DPR0726599_L1.htm,http://www3.registraduria.gov.co/elecciones/elecciones2014/presidente/2v/99PR2/DPR0799999_L1.htm,16,16,6011,3769,3591,68,3659,90,20,862,23.55,2729,74.58
SOATA,BOYACA,http://www3.registraduria.gov.co/elecciones/elecciones2014/presidente/2v/99PR2/DPR0726899_L1.htm,http://www3.registraduria.gov.co/elecciones/elecciones2014/presidente/2v/99PR2/DPR0799999_L1.htm,19,19,7203,4342,4126,118,4244,85,13,1593,37.53,2533,59.68
SOCHA,BOYACA,http://www3.registraduria.gov.co/elecciones/elecciones2014/presidente/2v/99PR2/DPR0727499_L1.htm,http://www3.registraduria.gov.co/elecciones/elecciones2014/presidente/2v/99PR2/DPR0799999_L1.htm,17,17,6118,2928,2647,123,2770,136,22,1059,38.23,1588,57.32
SOCOTA,BOYACA,http://www3.registraduria.gov.co/elecciones/elecciones2014/presidente/2v/99PR2/DPR0727199_L1.htm,http://www3.registraduria.gov.co/elecciones/elecciones2014/presidente/2v/99PR2/DPR0799999_L1.htm,20,20,5885,3180,3026,59,3085,69,26,743,24.08,2283,74.00
SOGAMOSO,BOYACA,http://www3.registraduria.gov.co/elecciones/elecciones2014/presidente/2v/99PR2/DPR0727799_L1.htm,http://www3.registraduria.gov.co/elecciones/elecciones2014/presidente/2v/99PR2/DPR0799999_L1.htm,209,209,84787,47460,42712,2452,45164,2211,85,19927,44.12,22785,50.44
SOMONDOCO,BOYACA,http://www3.registraduria.gov.co/elecciones/elecciones2014/presidente/2v/99PR2/DPR0728099_L1.htm,http://www3.registraduria.gov.co/elecciones/elecciones2014/presidente/2v/99PR2/DPR0799999_L1.htm,8,8,2827,1464,1372,46,1418,37,9,418,29.47,954,67.27
SORA,BOYACA,http://www3.registraduria.gov.co/elecciones/elecciones2014/presidente/2v/99PR2/DPR0728199_L1.htm,http://www3.registraduria.gov.co/elecciones/elecciones2014/presidente/2v/99PR2/DPR0799999_L1.htm,7,7,2431,1533,1437,40,1477,45,11,690,46.71,747,50.57
SORACA,BOYACA,http://www3.registraduria.gov.co/elecciones/elecciones2014/presidente/2v/99PR2/DPR0728299_L1.htm,http://www3.registraduria.gov.co/elecciones/elecciones2014/presidente/2v/99PR2/DPR0799999_L1.htm,13,13,5044,3203,3042,76,3118,77,8,773,24.79,2269,72.77
SOTAQUIRA,BOYACA,http://www3.registraduria.gov.co/elecciones/elecciones2014/presidente/2v/99PR2/DPR0728399_L1.htm,http://www3.registraduria.gov.co/elecciones/elecciones2014/presidente/2v/99PR2/DPR0799999_L1.htm,14,14,5174,2855,2710,60,2770,70,15,873,31.51,1837,66.31
SUSACON,BOYACA,http://www3.registraduria.gov.co/elecciones/elecciones2014/presidente/2v/99PR2/DPR0728699_L1.htm,http://www3.registraduria.gov.co/elecciones/elecciones2014/presidente/2v/99PR2/DPR0799999_L1.htm,8,8,2581,1413,1335,30,1365,31,17,454,33.26,881,64.54
SUTAMARCHAN,BOYACA,http://www3.registraduria.gov.co/elecciones/elecciones2014/presidente/2v/99PR2/DPR0728999_L1.htm,http://www3.registraduria.gov.co/elecciones/elecciones2014/presidente/2v/99PR2/DPR0799999_L1.htm,13,13,4949,3052,2915,93,3008,32,12,963,32.01,1952,64.89
SUTATENZA,BOYACA,http://www3.registraduria.gov.co/elecciones/elecciones2014/presidente/2v/99PR2/DPR0729299_L1.htm,http://www3.registraduria.gov.co/elecciones/elecciones2014/presidente/2v/99PR2/DPR0799999_L1.htm,10,10,3597,1907,1778,47,1825,67,15,618,33.86,1160,63.56
TASCO,BOYACA,http://www3.registraduria.gov.co/elecciones/elecciones2014/presidente/2v/99PR2/DPR0729899_L1.htm,http://www3.registraduria.gov.co/elecciones/elecciones2014/presidente/2v/99PR2/DPR0799999_L1.htm,13,13,4968,2484,2358,45,2403,73,8,1420,59.09,938,39.03
TENZA,BOYACA,http://www3.registraduria.gov.co/elecciones/elecciones2014/presidente/2v/99PR2/DPR0730199_L1.htm,http://www3.registraduria.gov.co/elecciones/elecciones2014/presidente/2v/99PR2/DPR0799999_L1.htm,9,9,3478,1855,1743,51,1794,48,13,568,31.66,1175,65.49
TIBANA,BOYACA,http://www3.registraduria.gov.co/elecciones/elecciones2014/presidente/2v/99PR2/DPR0730499_L1.htm,http://www3.registraduria.gov.co/elecciones/elecciones2014/presidente/2v/99PR2/DPR0799999_L1.htm,20,20,7410,3329,3156,71,3227,85,17,1629,50.48,1527,47.31
TIBASOSA,BOYACA,http://www3.registraduria.gov.co/elecciones/elecciones2014/presidente/2v/99PR2/DPR0730799_L1.htm,http://www3.registraduria.gov.co/elecciones/elecciones2014/presidente/2v/99PR2/DPR0799999_L1.htm,20,20,7716,4575,4195,163,4358,201,16,2004,45.98,2191,50.27
TINJACA,BOYACA,http://www3.registraduria.gov.co/elecciones/elecciones2014/presidente/2v/99PR2/DPR0731099_L1.htm,http://www3.registraduria.gov.co/elecciones/elecciones2014/presidente/2v/99PR2/DPR0799999_L1.htm,7,7,2559,1448,1355,47,1402,33,13,586,41.79,769,54.85
TIPACOQUE,BOYACA,http://www3.registraduria.gov.co/elecciones/elecciones2014/presidente/2v/99PR2/DPR0731199_L1.htm,http://www3.registraduria.gov.co/elecciones/elecciones2014/presidente/2v/99PR2/DPR0799999_L1.htm,9,9,3260,1683,1618,36,1654,17,12,714,43.16,904,54.65
TOCA,BOYACA,http://www3.registraduria.gov.co/elecciones/elecciones2014/presidente/2v/99PR2/DPR0731399_L1.htm,http://www3.registraduria.gov.co/elecciones/elecciones2014/presidente/2v/99PR2/DPR0799999_L1.htm,18,18,6746,3966,3692,164,3856,99,11,1617,41.93,2075,53.81
TOGUI,BOYACA,http://www3.registraduria.gov.co/elecciones/elecciones2014/presidente/2v/99PR2/DPR0731699_L1.htm,http://www3.registraduria.gov.co/elecciones/elecciones2014/presidente/2v/99PR2/DPR0799999_L1.htm,11,11,4190,1820,1699,55,1754,52,14,768,43.78,931,53.07
TOPAGA,BOYACA,http://www3.registraduria.gov.co/elecciones/elecciones2014/presidente/2v/99PR2/DPR0731999_L1.htm,http://www3.registraduria.gov.co/elecciones/elecciones2014/presidente/2v/99PR2/DPR0799999_L1.htm,8,8,2796,1735,1619,61,1680,50,5,499,29.70,1120,66.66
TOTA,BOYACA,http://www3.registraduria.gov.co/elecciones/elecciones2014/presidente/2v/99PR2/DPR0732299_L1.htm,http://www3.registraduria.gov.co/elecciones/elecciones2014/presidente/2v/99PR2/DPR0799999_L1.htm,12,12,3953,2212,2126,30,2156,39,17,533,24.72,1593,73.88
TUNJA,BOYACA,http://www3.registraduria.gov.co/elecciones/elecciones2014/presidente/2v/99PR2/DPR0700199_L1.htm,http://www3.registraduria.gov.co/elecciones/elecciones2014/presidente/2v/99PR2/DPR0799999_L1.htm,270,270,108550,62647,56186,3360,59546,3034,67,33160,55.68,23026,38.66
TUNUNGUA,BOYACA,http://www3.registraduria.gov.co/elecciones/elecciones2014/presidente/2v/99PR2/DPR0732499_L1.htm,http://www3.registraduria.gov.co/elecciones/elecciones2014/presidente/2v/99PR2/DPR0799999_L1.htm,4,4,1234,697,679,9,688,8,1,421,61.19,258,37.50
TURMEQUE,BOYACA,http://www3.registraduria.gov.co/elecciones/elecciones2014/presidente/2v/99PR2/DPR0732599_L1.htm,http://www3.registraduria.gov.co/elecciones/elecciones2014/presidente/2v/99PR2/DPR0799999_L1.htm,15,15,5703,2777,2557,139,2696,71,10,1126,41.76,1431,53.07
TUTA,BOYACA,http://www3.registraduria.gov.co/elecciones/elecciones2014/presidente/2v/99PR2/DPR0732899_L1.htm,http://www3.registraduria.gov.co/elecciones/elecciones2014/presidente/2v/99PR2/DPR0799999_L1.htm,19,19,6865,3985,3723,136,3859,113,13,1577,40.86,2146,55.61
TUTAZA,BOYACA,http://www3.registraduria.gov.co/elecciones/elecciones2014/presidente/2v/99PR2/DPR0733199_L1.htm,http://www3.registraduria.gov.co/elecciones/elecciones2014/presidente/2v/99PR2/DPR0799999_L1.htm,5,5,1759,1060,975,38,1013,45,2,274,27.04,701,69.20
UMBITA,BOYACA,http://www3.registraduria.gov.co/elecciones/elecciones2014/presidente/2v/99PR2/DPR0733499_L1.htm,http://www3.registraduria.gov.co/elecciones/elecciones2014/presidente/2v/99PR2/DPR0799999_L1.htm,15,15,5850,3374,3243,76,3319,46,9,627,18.89,2616,78.81
VENTAQUEMADA,BOYACA,http://www3.registraduria.gov.co/elecciones/elecciones2014/presidente/2v/99PR2/DPR0733799_L1.htm,http://www3.registraduria.gov.co/elecciones/elecciones2014/presidente/2v/99PR2/DPR0799999_L1.htm,28,28,10549,5283,4850,212,5062,209,12,1217,24.04,3633,71.77
VILLA DE LEIVA,BOYACA,http://www3.registraduria.gov.co/elecciones/elecciones2014/presidente/2v/99PR2/DPR0713999_L1.htm,http://www3.registraduria.gov.co/elecciones/elecciones2014/presidente/2v/99PR2/DPR0799999_L1.htm,25,25,9480,6133,5713,225,5938,174,21,2615,44.03,3098,52.17
VIRACACHA,BOYACA,http://www3.registraduria.gov.co/elecciones/elecciones2014/presidente/2v/99PR2/DPR0734099_L1.htm,http://www3.registraduria.gov.co/elecciones/elecciones2014/presidente/2v/99PR2/DPR0799999_L1.htm,7,7,2580,1483,1403,35,1438,36,9,321,22.32,1082,75.24
ZETAQUIRA,BOYACA,http://www3.registraduria.gov.co/elecciones/elecciones2014/presidente/2v/99PR2/DPR0734699_L1.htm,http://www3.registraduria.gov.co/elecciones/elecciones2014/presidente/2v/99PR2/DPR0799999_L1.htm,10,10,3771,1905,1809,69,1878,22,5,783,41.69,1026,54.63
AGUADAS,CALDAS,http://www3.registraduria.gov.co/elecciones/elecciones2014/presidente/2v/99PR2/DPR0900499_L1.htm,http://www3.registraduria.gov.co/elecciones/elecciones2014/presidente/2v/99PR2/DPR0999999_L1.htm,54,54,18626,9918,9259,285,9544,282,92,1952,20.45,7307,76.56
ANSERMA,CALDAS,http://www3.registraduria.gov.co/elecciones/elecciones2014/presidente/2v/99PR2/DPR0900799_L1.htm,http://www3.registraduria.gov.co/elecciones/elecciones2014/presidente/2v/99PR2/DPR0999999_L1.htm,77,77,27331,15514,14417,539,14956,491,67,2495,16.68,11922,79.71
ARANZAZU,CALDAS,http://www3.registraduria.gov.co/elecciones/elecciones2014/presidente/2v/99PR2/DPR0901399_L1.htm,http://www3.registraduria.gov.co/elecciones/elecciones2014/presidente/2v/99PR2/DPR0999999_L1.htm,33,33,11333,5810,5444,167,5611,168,31,972,17.32,4472,79.70
BELALCAZAR,CALDAS,http://www3.registraduria.gov.co/elecciones/elecciones2014/presidente/2v/99PR2/DPR0902299_L1.htm,http://www3.registraduria.gov.co/elecciones/elecciones2014/presidente/2v/99PR2/DPR0999999_L1.htm,29,29,9981,5024,4779,126,4905,90,29,1495,30.47,3284,66.95
CHINCHINA,CALDAS,http://www3.registraduria.gov.co/elecciones/elecciones2014/presidente/2v/99PR2/DPR0903499_L1.htm,http://www3.registraduria.gov.co/elecciones/elecciones2014/presidente/2v/99PR2/DPR0999999_L1.htm,95,95,41818,21636,19675,1009,20684,864,88,6963,33.66,12712,61.45
FILADELFIA,CALDAS,http://www3.registraduria.gov.co/elecciones/elecciones2014/presidente/2v/99PR2/DPR0903799_L1.htm,http://www3.registraduria.gov.co/elecciones/elecciones2014/presidente/2v/99PR2/DPR0999999_L1.htm,28,28,9505,4955,4693,128,4821,91,43,1624,33.68,3069,63.65
LA DORADA,CALDAS,http://www3.registraduria.gov.co/elecciones/elecciones2014/presidente/2v/99PR2/DPR0904999_L1.htm,http://www3.registraduria.gov.co/elecciones/elecciones2014/presidente/2v/99PR2/DPR0999999_L1.htm,143,143,56579,26852,24716,898,25614,1150,88,9868,38.52,14848,57.96
LA MERCED,CALDAS,http://www3.registraduria.gov.co/elecciones/elecciones2014/presidente/2v/99PR2/DPR0905299_L1.htm,http://www3.registraduria.gov.co/elecciones/elecciones2014/presidente/2v/99PR2/DPR0999999_L1.htm,18,18,5612,2823,2671,79,2750,57,16,942,34.25,1729,62.87
MANIZALES,CALDAS,http://www3.registraduria.gov.co/elecciones/elecciones2014/presidente/2v/99PR2/DPR0900199_L1.htm,http://www3.registraduria.gov.co/elecciones/elecciones2014/presidente/2v/99PR2/DPR0999999_L1.htm,797,797,311783,172232,151933,12076,164009,7726,497,62864,38.32,89069,54.30
MANZANARES,CALDAS,http://www3.registraduria.gov.co/elecciones/elecciones2014/presidente/2v/99PR2/DPR0905599_L1.htm,http://www3.registraduria.gov.co/elecciones/elecciones2014/presidente/2v/99PR2/DPR0999999_L1.htm,44,44,15257,7980,7653,148,7801,140,39,1630,20.89,6023,77.20
MARMATO,CALDAS,http://www3.registraduria.gov.co/elecciones/elecciones2014/presidente/2v/99PR2/DPR0905899_L1.htm,http://www3.registraduria.gov.co/elecciones/elecciones2014/presidente/2v/99PR2/DPR0999999_L1.htm,20,20,6275,2803,2479,139,2618,162,23,742,28.34,1737,66.34
MARQUETALIA,CALDAS,http://www3.registraduria.gov.co/elecciones/elecciones2014/presidente/2v/99PR2/DPR0906199_L1.htm,http://www3.registraduria.gov.co/elecciones/elecciones2014/presidente/2v/99PR2/DPR0999999_L1.htm,30,30,11221,6111,5928,70,5998,91,22,898,14.97,5030,83.86
MARULANDA,CALDAS,http://www3.registraduria.gov.co/elecciones/elecciones2014/presidente/2v/99PR2/DPR0906799_L1.htm,http://www3.registraduria.gov.co/elecciones/elecciones2014/presidente/2v/99PR2/DPR0999999_L1.htm,10,10,2674,1420,1359,32,1391,17,12,479,34.43,880,63.26
NEIRA,CALDAS,http://www3.registraduria.gov.co/elecciones/elecciones2014/presidente/2v/99PR2/DPR0907699_L1.htm,http://www3.registraduria.gov.co/elecciones/elecciones2014/presidente/2v/99PR2/DPR0999999_L1.htm,48,48,18885,10097,9299,399,9698,320,79,2989,30.82,6310,65.06
NORCASIA,CALDAS,http://www3.registraduria.gov.co/elecciones/elecciones2014/presidente/2v/99PR2/DPR0907899_L1.htm,http://www3.registraduria.gov.co/elecciones/elecciones2014/presidente/2v/99PR2/DPR0999999_L1.htm,15,15,5564,2791,2612,78,2690,70,31,1245,46.28,1367,50.81
PACORA,CALDAS,http://www3.registraduria.gov.co/elecciones/elecciones2014/presidente/2v/99PR2/DPR0907999_L1.htm,http://www3.registraduria.gov.co/elecciones/elecciones2014/presidente/2v/99PR2/DPR0999999_L1.htm,34,34,11902,6610,6254,175,6429,139,42,2325,36.16,3929,61.11
PALESTINA,CALDAS,http://www3.registraduria.gov.co/elecciones/elecciones2014/presidente/2v/99PR2/DPR0908299_L1.htm,http://www3.registraduria.gov.co/elecciones/elecciones2014/presidente/2v/99PR2/DPR0999999_L1.htm,40,40,15055,7619,7230,163,7393,194,32,3307,44.73,3923,53.06
PENSILVANIA,CALDAS,http://www3.registraduria.gov.co/elecciones/elecciones2014/presidente/2v/99PR2/DPR0908599_L1.htm,http://www3.registraduria.gov.co/elecciones/elecciones2014/presidente/2v/99PR2/DPR0999999_L1.htm,48,48,16824,9590,9276,125,9401,132,57,1135,12.07,8141,86.59
RIOSUCIO,CALDAS,http://www3.registraduria.gov.co/elecciones/elecciones2014/presidente/2v/99PR2/DPR0910399_L1.htm,http://www3.registraduria.gov.co/elecciones/elecciones2014/presidente/2v/99PR2/DPR0999999_L1.htm,96,96,36715,19242,17704,703,18407,687,148,6191,33.63,11513,62.54
RISARALDA,CALDAS,http://www3.registraduria.gov.co/elecciones/elecciones2014/presidente/2v/99PR2/DPR0910699_L1.htm,http://www3.registraduria.gov.co/elecciones/elecciones2014/presidente/2v/99PR2/DPR0999999_L1.htm,29,29,10646,5438,5151,125,5276,126,36,1331,25.22,3820,72.40
SALAMINA,CALDAS,http://www3.registraduria.gov.co/elecciones/elecciones2014/presidente/2v/99PR2/DPR0910999_L1.htm,http://www3.registraduria.gov.co/elecciones/elecciones2014/presidente/2v/99PR2/DPR0999999_L1.htm,42,42,15417,7801,7327,228,7555,187,59,2307,30.53,5020,66.44
SAMANA,CALDAS,http://www3.registraduria.gov.co/elecciones/elecciones2014/presidente/2v/99PR2/DPR0911599_L1.htm,http://www3.registraduria.gov.co/elecciones/elecciones2014/presidente/2v/99PR2/DPR0999999_L1.htm,47,47,16062,8764,8449,132,8581,120,63,2363,27.53,6086,70.92
SAN JOSE,CALDAS,http://www3.registraduria.gov.co/elecciones/elecciones2014/presidente/2v/99PR2/DPR0912099_L1.htm,http://www3.registraduria.gov.co/elecciones/elecciones2014/presidente/2v/99PR2/DPR0999999_L1.htm,13,13,4815,2678,2586,58,2644,22,12,637,24.09,1949,73.71
SUPIA,CALDAS,http://www3.registraduria.gov.co/elecciones/elecciones2014/presidente/2v/99PR2/DPR0912499_L1.htm,http://www3.registraduria.gov.co/elecciones/elecciones2014/presidente/2v/99PR2/DPR0999999_L1.htm,54,54,20395,10916,9731,414,10145,673,98,2987,29.44,6744,66.47
VICTORIA,CALDAS,http://www3.registraduria.gov.co/elecciones/elecciones2014/presidente/2v/99PR2/DPR0912799_L1.htm,http://www3.registraduria.gov.co/elecciones/elecciones2014/presidente/2v/99PR2/DPR0999999_L1.htm,24,24,8297,4276,4085,74,4159,102,15,1763,42.38,2322,55.83
VILLAMARIA,CALDAS,http://www3.registraduria.gov.co/elecciones/elecciones2014/presidente/2v/99PR2/DPR0913099_L1.htm,http://www3.registraduria.gov.co/elecciones/elecciones2014/presidente/2v/99PR2/DPR0999999_L1.htm,89,89,36472,21260,19010,1284,20294,859,107,8453,41.65,10557,52.02
VITERBO,CALDAS,http://www3.registraduria.gov.co/elecciones/elecciones2014/presidente/2v/99PR2/DPR0913399_L1.htm,http://www3.registraduria.gov.co/elecciones/elecciones2014/presidente/2v/99PR2/DPR0999999_L1.htm,36,36,12584,7017,6667,206,6873,115,29,1282,18.65,5385,78.35
ALBANIA,CAQUETA,http://www3.registraduria.gov.co/elecciones/elecciones2014/presidente/2v/99PR2/DPR4400299_L1.htm,http://www3.registraduria.gov.co/elecciones/elecciones2014/presidente/2v/99PR2/DPR4499999_L1.htm,11,11,3717,1757,1667,55,1722,26,9,528,30.66,1139,66.14
BELEN DE LOS ANDAQUIES,CAQUETA,http://www3.registraduria.gov.co/elecciones/elecciones2014/presidente/2v/99PR2/DPR4400499_L1.htm,http://www3.registraduria.gov.co/elecciones/elecciones2014/presidente/2v/99PR2/DPR4499999_L1.htm,19,19,7297,3280,3054,123,3177,78,25,848,26.69,2206,69.43
CARTAGENA DEL CHAIRA,CAQUETA,http://www3.registraduria.gov.co/elecciones/elecciones2014/presidente/2v/99PR2/DPR4400399_L1.htm,http://www3.registraduria.gov.co/elecciones/elecciones2014/presidente/2v/99PR2/DPR4499999_L1.htm,44,44,16691,5090,4760,213,4973,83,34,3235,65.05,1525,30.66
CURILLO,CAQUETA,http://www3.registraduria.gov.co/elecciones/elecciones2014/presidente/2v/99PR2/DPR4401299_L1.htm,http://www3.registraduria.gov.co/elecciones/elecciones2014/presidente/2v/99PR2/DPR4499999_L1.htm,20,20,7284,2274,2133,84,2217,38,19,693,31.25,1440,64.95
EL DONCELLO,CAQUETA,http://www3.registraduria.gov.co/elecciones/elecciones2014/presidente/2v/99PR2/DPR4400599_L1.htm,http://www3.registraduria.gov.co/elecciones/elecciones2014/presidente/2v/99PR2/DPR4499999_L1.htm,43,43,15487,6154,5781,237,6018,101,35,1774,29.47,4007,66.58
EL PAUJIL,CAQUETA,http://www3.registraduria.gov.co/elecciones/elecciones2014/presidente/2v/99PR2/DPR4400699_L1.htm,http://www3.registraduria.gov.co/elecciones/elecciones2014/presidente/2v/99PR2/DPR4499999_L1.htm,30,30,11413,3566,3352,140,3492,50,24,1488,42.61,1864,53.37
FLORENCIA,CAQUETA,http://www3.registraduria.gov.co/elecciones/elecciones2014/presidente/2v/99PR2/DPR4400199_L1.htm,http://www3.registraduria.gov.co/elecciones/elecciones2014/presidente/2v/99PR2/DPR4499999_L1.htm,272,272,108549,55266,51674,2285,53959,1123,184,13128,24.32,38546,71.43
LA MONTAÑITA,CAQUETA,http://www3.registraduria.gov.co/elecciones/elecciones2014/presidente/2v/99PR2/DPR4400799_L1.htm,http://www3.registraduria.gov.co/elecciones/elecciones2014/presidente/2v/99PR2/DPR4499999_L1.htm,26,26,9646,2845,2686,93,2779,47,19,1361,48.97,1325,47.67
MILAN,CAQUETA,http://www3.registraduria.gov.co/elecciones/elecciones2014/presidente/2v/99PR2/DPR4401699_L1.htm,http://www3.registraduria.gov.co/elecciones/elecciones2014/presidente/2v/99PR2/DPR4499999_L1.htm,19,19,6479,1758,1674,51,1725,23,10,673,39.01,1001,58.02
MORELIA,CAQUETA,http://www3.registraduria.gov.co/elecciones/elecciones2014/presidente/2v/99PR2/DPR4401799_L1.htm,http://www3.registraduria.gov.co/elecciones/elecciones2014/presidente/2v/99PR2/DPR4499999_L1.htm,9,9,3243,1468,1392,44,1436,22,10,277,19.28,1115,77.64
PUERTO RICO,CAQUETA,http://www3.registraduria.gov.co/elecciones/elecciones2014/presidente/2v/99PR2/DPR4400999_L1.htm,http://www3.registraduria.gov.co/elecciones/elecciones2014/presidente/2v/99PR2/DPR4499999_L1.htm,49,49,17800,6380,5928,298,6226,117,37,2406,38.64,3522,56.56
SAN JOSE DEL FRAGUA,CAQUETA,http://www3.registraduria.gov.co/elecciones/elecciones2014/presidente/2v/99PR2/DPR4402099_L1.htm,http://www3.registraduria.gov.co/elecciones/elecciones2014/presidente/2v/99PR2/DPR4499999_L1.htm,25,25,8619,3761,3495,169,3664,67,30,1129,30.81,2366,64.57
SAN VICENTE DEL CAGUAN,CAQUETA,http://www3.registraduria.gov.co/elecciones/elecciones2014/presidente/2v/99PR2/DPR4401099_L1.htm,http://www3.registraduria.gov.co/elecciones/elecciones2014/presidente/2v/99PR2/DPR4499999_L1.htm,79,79,28528,9739,9223,332,9555,140,44,4486,46.94,4737,49.57
SOLANO,CAQUETA,http://www3.registraduria.gov.co/elecciones/elecciones2014/presidente/2v/99PR2/DPR4402299_L1.htm,http://www3.registraduria.gov.co/elecciones/elecciones2014/presidente/2v/99PR2/DPR4499999_L1.htm,21,21,7316,1531,1455,46,1501,23,7,870,57.96,585,38.97
SOLITA,CAQUETA,http://www3.registraduria.gov.co/elecciones/elecciones2014/presidente/2v/99PR2/DPR4402499_L1.htm,http://www3.registraduria.gov.co/elecciones/elecciones2014/presidente/2v/99PR2/DPR4499999_L1.htm,14,14,5391,1748,1624,86,1710,28,10,721,42.16,903,52.80
VALPARAISO,CAQUETA,http://www3.registraduria.gov.co/elecciones/elecciones2014/presidente/2v/99PR2/DPR4404099_L1.htm,http://www3.registraduria.gov.co/elecciones/elecciones2014/presidente/2v/99PR2/DPR4499999_L1.htm,17,17,6119,2603,2490,61,2551,38,14,1002,39.27,1488,58.33
AGUAZUL,CASANARE,http://www3.registraduria.gov.co/elecciones/elecciones2014/presidente/2v/99PR2/DPR4604099_L1.htm,http://www3.registraduria.gov.co/elecciones/elecciones2014/presidente/2v/99PR2/DPR4699999_L1.htm,69,69,24755,15316,13997,674,14671,601,44,3074,20.95,10923,74.45
CHAMEZA,CASANARE,http://www3.registraduria.gov.co/elecciones/elecciones2014/presidente/2v/99PR2/DPR4612099_L1.htm,http://www3.registraduria.gov.co/elecciones/elecciones2014/presidente/2v/99PR2/DPR4699999_L1.htm,4,4,1393,937,910,20,930,6,1,330,35.48,580,62.36
HATO COROZAL,CASANARE,http://www3.registraduria.gov.co/elecciones/elecciones2014/presidente/2v/99PR2/DPR4632099_L1.htm,http://www3.registraduria.gov.co/elecciones/elecciones2014/presidente/2v/99PR2/DPR4699999_L1.htm,28,28,6746,3869,3686,92,3778,78,13,541,14.31,3145,83.24
LA SALINA,CASANARE,http://www3.registraduria.gov.co/elecciones/elecciones2014/presidente/2v/99PR2/DPR4648099_L1.htm,http://www3.registraduria.gov.co/elecciones/elecciones2014/presidente/2v/99PR2/DPR4699999_L1.htm,3,3,803,419,390,22,412,4,3,235,57.03,155,37.62
MANI,CASANARE,http://www3.registraduria.gov.co/elecciones/elecciones2014/presidente/2v/99PR2/DPR4652099_L1.htm,http://www3.registraduria.gov.co/elecciones/elecciones2014/presidente/2v/99PR2/DPR4699999_L1.htm,29,29,8922,5075,4784,168,4952,100,23,875,17.66,3909,78.93
MONTERREY,CASANARE,http://www3.registraduria.gov.co/elecciones/elecciones2014/presidente/2v/99PR2/DPR4654099_L1.htm,http://www3.registraduria.gov.co/elecciones/elecciones2014/presidente/2v/99PR2/DPR4699999_L1.htm,31,31,10294,6198,5698,339,6037,146,15,1246,20.63,4452,73.74
NUNCHIA,CASANARE,http://www3.registraduria.gov.co/elecciones/elecciones2014/presidente/2v/99PR2/DPR4656099_L1.htm,http://www3.registraduria.gov.co/elecciones/elecciones2014/presidente/2v/99PR2/DPR4699999_L1.htm,26,26,5940,3590,3409,93,3502,57,31,427,12.19,2982,85.15
OROCUE,CASANARE,http://www3.registraduria.gov.co/elecciones/elecciones2014/presidente/2v/99PR2/DPR4664099_L1.htm,http://www3.registraduria.gov.co/elecciones/elecciones2014/presidente/2v/99PR2/DPR4699999_L1.htm,23,23,7223,3228,3062,93,3155,62,11,718,22.75,2344,74.29
PAZ DE ARIPORO (MORENO),CASANARE,http://www3.registraduria.gov.co/elecciones/elecciones2014/presidente/2v/99PR2/DPR4668099_L1.htm,http://www3.registraduria.gov.co/elecciones/elecciones2014/presidente/2v/99PR2/DPR4699999_L1.htm,59,59,21104,12340,11790,302,12092,200,48,1439,11.90,10351,85.60
PORE,CASANARE,http://www3.registraduria.gov.co/elecciones/elecciones2014/presidente/2v/99PR2/DPR4670099_L1.htm,http://www3.registraduria.gov.co/elecciones/elecciones2014/presidente/2v/99PR2/DPR4699999_L1.htm,15,15,5788,3738,3570,77,3647,67,24,502,13.76,3068,84.12
RECETOR,CASANARE,http://www3.registraduria.gov.co/elecciones/elecciones2014/presidente/2v/99PR2/DPR4676099_L1.htm,http://www3.registraduria.gov.co/elecciones/elecciones2014/presidente/2v/99PR2/DPR4699999_L1.htm,5,5,1295,767,706,38,744,19,4,229,30.77,477,64.11
SABANALARGA,CASANARE,http://www3.registraduria.gov.co/elecciones/elecciones2014/presidente/2v/99PR2/DPR4680099_L1.htm,http://www3.registraduria.gov.co/elecciones/elecciones2014/presidente/2v/99PR2/DPR4699999_L1.htm,8,8,2627,1600,1519,52,1571,26,3,496,31.57,1023,65.11
SACAMA,CASANARE,http://www3.registraduria.gov.co/elecciones/elecciones2014/presidente/2v/99PR2/DPR4681599_L1.htm,http://www3.registraduria.gov.co/elecciones/elecciones2014/presidente/2v/99PR2/DPR4699999_L1.htm,4,4,1456,646,599,34,633,6,7,397,62.71,202,31.91
SAN LUIS DE PALENQUE,CASANARE,http://www3.registraduria.gov.co/elecciones/elecciones2014/presidente/2v/99PR2/DPR4683099_L1.htm,http://www3.registraduria.gov.co/elecciones/elecciones2014/presidente/2v/99PR2/DPR4699999_L1.htm,18,18,5327,2953,2798,89,2887,54,12,312,10.80,2486,86.11
TAMARA,CASANARE,http://www3.registraduria.gov.co/elecciones/elecciones2014/presidente/2v/99PR2/DPR4684099_L1.htm,http://www3.registraduria.gov.co/elecciones/elecciones2014/presidente/2v/99PR2/DPR4699999_L1.htm,14,14,4116,2377,2257,55,2312,43,22,387,16.73,1870,80.88
TAURAMENA,CASANARE,http://www3.registraduria.gov.co/elecciones/elecciones2014/presidente/2v/99PR2/DPR4685099_L1.htm,http://www3.registraduria.gov.co/elecciones/elecciones2014/presidente/2v/99PR2/DPR4699999_L1.htm,39,39,14178,8631,8009,338,8347,263,21,1396,16.72,6613,79.22
TRINIDAD,CASANARE,http://www3.registraduria.gov.co/elecciones/elecciones2014/presidente/2v/99PR2/DPR4686599_L1.htm,http://www3.registraduria.gov.co/elecciones/elecciones2014/presidente/2v/99PR2/DPR4699999_L1.htm,29,29,8764,4871,4633,135,4768,81,22,567,11.89,4066,85.27
VILLANUEVA,CASANARE,http://www3.registraduria.gov.co/elecciones/elecciones2014/presidente/2v/99PR2/DPR4688099_L1.htm,http://www3.registraduria.gov.co/elecciones/elecciones2014/presidente/2v/99PR2/DPR4699999_L1.htm,47,47,18048,9825,9075,418,9493,304,28,2261,23.81,6814,71.77
YOPAL,CASANARE,http://www3.registraduria.gov.co/elecciones/elecciones2014/presidente/2v/99PR2/DPR4600199_L1.htm,http://www3.registraduria.gov.co/elecciones/elecciones2014/presidente/2v/99PR2/DPR4699999_L1.htm,216,216,89809,54786,50710,2248,52958,1711,117,9730,18.37,40980,77.38
ALMAGUER,CAUCA,http://www3.registraduria.gov.co/elecciones/elecciones2014/presidente/2v/99PR2/DPR1100499_L1.htm,http://www3.registraduria.gov.co/elecciones/elecciones2014/presidente/2v/99PR2/DPR1199999_L1.htm,36,36,11985,5921,5797,42,5839,47,35,5441,93.18,356,6.09
ARGELIA,CAUCA,http://www3.registraduria.gov.co/elecciones/elecciones2014/presidente/2v/99PR2/DPR1100599_L1.htm,http://www3.registraduria.gov.co/elecciones/elecciones2014/presidente/2v/99PR2/DPR1199999_L1.htm,45,45,15134,7814,7610,123,7733,66,15,7275,94.07,335,4.33
BALBOA,CAUCA,http://www3.registraduria.gov.co/elecciones/elecciones2014/presidente/2v/99PR2/DPR1100699_L1.htm,http://www3.registraduria.gov.co/elecciones/elecciones2014/presidente/2v/99PR2/DPR1199999_L1.htm,43,43,15105,6754,6615,65,6680,42,32,6071,90.88,544,8.14
BOLIVAR,CAUCA,http://www3.registraduria.gov.co/elecciones/elecciones2014/presidente/2v/99PR2/DPR1100799_L1.htm,http://www3.registraduria.gov.co/elecciones/elecciones2014/presidente/2v/99PR2/DPR1199999_L1.htm,120,120,30819,13587,13185,169,13354,182,51,11125,83.30,2060,15.42
BUENOS AIRES,CAUCA,http://www3.registraduria.gov.co/elecciones/elecciones2014/presidente/2v/99PR2/DPR1101099_L1.htm,http://www3.registraduria.gov.co/elecciones/elecciones2014/presidente/2v/99PR2/DPR1199999_L1.htm,46,46,14715,7563,7248,142,7390,134,39,5981,80.93,1267,17.14
CAJIBIO,CAUCA,http://www3.registraduria.gov.co/elecciones/elecciones2014/presidente/2v/99PR2/DPR1101399_L1.htm,http://www3.registraduria.gov.co/elecciones/elecciones2014/presidente/2v/99PR2/DPR1199999_L1.htm,64,64,22136,10038,9532,224,9756,220,62,7054,72.30,2478,25.39
CALDONO,CAUCA,http://www3.registraduria.gov.co/elecciones/elecciones2014/presidente/2v/99PR2/DPR1101699_L1.htm,http://www3.registraduria.gov.co/elecciones/elecciones2014/presidente/2v/99PR2/DPR1199999_L1.htm,52,52,19203,9954,9474,178,9652,195,107,7871,81.54,1603,16.60
CALOTO,CAUCA,http://www3.registraduria.gov.co/elecciones/elecciones2014/presidente/2v/99PR2/DPR1101999_L1.htm,http://www3.registraduria.gov.co/elecciones/elecciones2014/presidente/2v/99PR2/DPR1199999_L1.htm,51,51,17055,9610,9185,201,9386,180,44,7325,78.04,1860,19.81
CORINTO,CAUCA,http://www3.registraduria.gov.co/elecciones/elecciones2014/presidente/2v/99PR2/DPR1102299_L1.htm,http://www3.registraduria.gov.co/elecciones/elecciones2014/presidente/2v/99PR2/DPR1199999_L1.htm,47,47,16421,9756,9295,253,9548,176,32,8151,85.36,1144,11.98
EL TAMBO,CAUCA,http://www3.registraduria.gov.co/elecciones/elecciones2014/presidente/2v/99PR2/DPR1102599_L1.htm,http://www3.registraduria.gov.co/elecciones/elecciones2014/presidente/2v/99PR2/DPR1199999_L1.htm,115,115,33278,15954,15152,366,15518,319,117,10746,69.24,4406,28.39
FLORENCIA,CAUCA,http://www3.registraduria.gov.co/elecciones/elecciones2014/presidente/2v/99PR2/DPR1102799_L1.htm,http://www3.registraduria.gov.co/elecciones/elecciones2014/presidente/2v/99PR2/DPR1199999_L1.htm,12,12,4406,2459,2357,53,2410,23,26,1895,78.63,462,19.17
GUACHENE,CAUCA,http://www3.registraduria.gov.co/elecciones/elecciones2014/presidente/2v/99PR2/DPR1102999_L1.htm,http://www3.registraduria.gov.co/elecciones/elecciones2014/presidente/2v/99PR2/DPR1199999_L1.htm,35,35,11548,8059,7838,94,7932,108,19,7191,90.65,647,8.15
GUAPI,CAUCA,http://www3.registraduria.gov.co/elecciones/elecciones2014/presidente/2v/99PR2/DPR1102899_L1.htm,http://www3.registraduria.gov.co/elecciones/elecciones2014/presidente/2v/99PR2/DPR1199999_L1.htm,61,61,18850,8215,8047,53,8100,89,26,7280,89.87,767,9.46
INZA,CAUCA,http://www3.registraduria.gov.co/elecciones/elecciones2014/presidente/2v/99PR2/DPR1103199_L1.htm,http://www3.registraduria.gov.co/elecciones/elecciones2014/presidente/2v/99PR2/DPR1199999_L1.htm,48,48,15700,6795,6399,137,6536,194,65,3466,53.02,2933,44.87
JAMBALO,CAUCA,http://www3.registraduria.gov.co/elecciones/elecciones2014/presidente/2v/99PR2/DPR1103499_L1.htm,http://www3.registraduria.gov.co/elecciones/elecciones2014/presidente/2v/99PR2/DPR1199999_L1.htm,23,23,7591,3942,3656,118,3774,111,57,3341,88.52,315,8.34
LA SIERRA,CAUCA,http://www3.registraduria.gov.co/elecciones/elecciones2014/presidente/2v/99PR2/DPR1103799_L1.htm,http://www3.registraduria.gov.co/elecciones/elecciones2014/presidente/2v/99PR2/DPR1199999_L1.htm,24,24,8547,4161,3888,121,4009,116,36,2364,58.96,1524,38.01
LA VEGA,CAUCA,http://www3.registraduria.gov.co/elecciones/elecciones2014/presidente/2v/99PR2/DPR1104099_L1.htm,http://www3.registraduria.gov.co/elecciones/elecciones2014/presidente/2v/99PR2/DPR1199999_L1.htm,47,47,14686,6091,5834,115,5949,88,54,4519,75.96,1315,22.10
LOPEZ (MICAY),CAUCA,http://www3.registraduria.gov.co/elecciones/elecciones2014/presidente/2v/99PR2/DPR1104399_L1.htm,http://www3.registraduria.gov.co/elecciones/elecciones2014/presidente/2v/99PR2/DPR1199999_L1.htm,48,48,12215,4794,4719,44,4763,20,11,4388,92.12,331,6.94
MERCADERES,CAUCA,http://www3.registraduria.gov.co/elecciones/elecciones2014/presidente/2v/99PR2/DPR1104699_L1.htm,http://www3.registraduria.gov.co/elecciones/elecciones2014/presidente/2v/99PR2/DPR1199999_L1.htm,44,44,13654,6509,6280,98,6378,68,63,5340,83.72,940,14.73
MIRANDA,CAUCA,http://www3.registraduria.gov.co/elecciones/elecciones2014/presidente/2v/99PR2/DPR1104999_L1.htm,http://www3.registraduria.gov.co/elecciones/elecciones2014/presidente/2v/99PR2/DPR1199999_L1.htm,50,50,17814,11015,10519,273,10792,202,21,8521,78.95,1998,18.51
MORALES,CAUCA,http://www3.registraduria.gov.co/elecciones/elecciones2014/presidente/2v/99PR2/DPR1105299_L1.htm,http://www3.registraduria.gov.co/elecciones/elecciones2014/presidente/2v/99PR2/DPR1199999_L1.htm,50,50,17411,8337,7992,175,8167,122,48,5981,73.23,2011,24.62
PADILLA,CAUCA,http://www3.registraduria.gov.co/elecciones/elecciones2014/presidente/2v/99PR2/DPR1105399_L1.htm,http://www3.registraduria.gov.co/elecciones/elecciones2014/presidente/2v/99PR2/DPR1199999_L1.htm,18,18,6298,4088,3957,50,4007,66,15,3715,92.71,242,6.03
PAEZ (BELALCAZAR),CAUCA,http://www3.registraduria.gov.co/elecciones/elecciones2014/presidente/2v/99PR2/DPR1105599_L1.htm,http://www3.registraduria.gov.co/elecciones/elecciones2014/presidente/2v/99PR2/DPR1199999_L1.htm,58,58,18450,8243,7700,206,7906,251,86,5179,65.50,2521,31.88
PATIA (EL BORDO),CAUCA,http://www3.registraduria.gov.co/elecciones/elecciones2014/presidente/2v/99PR2/DPR1105899_L1.htm,http://www3.registraduria.gov.co/elecciones/elecciones2014/presidente/2v/99PR2/DPR1199999_L1.htm,74,74,24751,8000,7503,278,7781,184,35,5175,66.50,2328,29.91
PIAMONTE,CAUCA,http://www3.registraduria.gov.co/elecciones/elecciones2014/presidente/2v/99PR2/DPR1106099_L1.htm,http://www3.registraduria.gov.co/elecciones/elecciones2014/presidente/2v/99PR2/DPR1199999_L1.htm,19,19,4591,1865,1738,83,1821,37,7,929,51.01,809,44.42
PIENDAMO,CAUCA,http://www3.registraduria.gov.co/elecciones/elecciones2014/presidente/2v/99PR2/DPR1106199_L1.htm,http://www3.registraduria.gov.co/elecciones/elecciones2014/presidente/2v/99PR2/DPR1199999_L1.htm,75,75,25260,11956,11093,486,11579,310,67,6170,53.28,4923,42.51
POPAYAN,CAUCA,http://www3.registraduria.gov.co/elecciones/elecciones2014/presidente/2v/99PR2/DPR1100199_L1.htm,http://www3.registraduria.gov.co/elecciones/elecciones2014/presidente/2v/99PR2/DPR1199999_L1.htm,533,533,212419,111225,102829,5062,107891,2992,342,62529,57.95,40300,37.35
PUERTO TEJADA,CAUCA,http://www3.registraduria.gov.co/elecciones/elecciones2014/presidente/2v/99PR2/DPR1106499_L1.htm,http://www3.registraduria.gov.co/elecciones/elecciones2014/presidente/2v/99PR2/DPR1199999_L1.htm,73,73,30555,17647,16990,311,17301,291,55,15406,89.04,1584,9.15
PURACE (COCONUCO),CAUCA,http://www3.registraduria.gov.co/elecciones/elecciones2014/presidente/2v/99PR2/DPR1106799_L1.htm,http://www3.registraduria.gov.co/elecciones/elecciones2014/presidente/2v/99PR2/DPR1199999_L1.htm,22,22,8219,3919,3715,104,3819,78,22,2697,70.62,1018,26.65
ROSAS,CAUCA,http://www3.registraduria.gov.co/elecciones/elecciones2014/presidente/2v/99PR2/DPR1107099_L1.htm,http://www3.registraduria.gov.co/elecciones/elecciones2014/presidente/2v/99PR2/DPR1199999_L1.htm,24,24,8158,4092,3861,100,3961,102,29,2491,62.88,1370,34.58
SAN SEBASTIAN,CAUCA,http://www3.registraduria.gov.co/elecciones/elecciones2014/presidente/2v/99PR2/DPR1107399_L1.htm,http://www3.registraduria.gov.co/elecciones/elecciones2014/presidente/2v/99PR2/DPR1199999_L1.htm,21,21,6980,4005,3886,48,3934,25,46,3110,79.05,776,19.72
SANTA ROSA,CAUCA,http://www3.registraduria.gov.co/elecciones/elecciones2014/presidente/2v/99PR2/DPR1107999_L1.htm,http://www3.registraduria.gov.co/elecciones/elecciones2014/presidente/2v/99PR2/DPR1199999_L1.htm,16,16,3931,1593,1527,26,1553,32,8,860,55.37,667,42.94
SANTANDER DE QUILICHAO,CAUCA,http://www3.registraduria.gov.co/elecciones/elecciones2014/presidente/2v/99PR2/DPR1107699_L1.htm,http://www3.registraduria.gov.co/elecciones/elecciones2014/presidente/2v/99PR2/DPR1199999_L1.htm,164,164,68797,35081,32656,1211,33867,1066,148,22672,66.94,9984,29.48
SILVIA,CAUCA,http://www3.registraduria.gov.co/elecciones/elecciones2014/presidente/2v/99PR2/DPR1108299_L1.htm,http://www3.registraduria.gov.co/elecciones/elecciones2014/presidente/2v/99PR2/DPR1199999_L1.htm,64,64,20946,11048,10470,255,10725,241,82,8850,82.51,1620,15.10
SOTARA (PAISPAMBA),CAUCA,http://www3.registraduria.gov.co/elecciones/elecciones2014/presidente/2v/99PR2/DPR1108599_L1.htm,http://www3.registraduria.gov.co/elecciones/elecciones2014/presidente/2v/99PR2/DPR1199999_L1.htm,23,23,6972,3593,3416,70,3486,67,40,2503,71.80,913,26.19
SUAREZ,CAUCA,http://www3.registraduria.gov.co/elecciones/elecciones2014/presidente/2v/99PR2/DPR1108799_L1.htm,http://www3.registraduria.gov.co/elecciones/elecciones2014/presidente/2v/99PR2/DPR1199999_L1.htm,47,47,15309,6876,6539,151,6690,141,45,5219,78.01,1320,19.73
SUCRE,CAUCA,http://www3.registraduria.gov.co/elecciones/elecciones2014/presidente/2v/99PR2/DPR1108699_L1.htm,http://www3.registraduria.gov.co/elecciones/elecciones2014/presidente/2v/99PR2/DPR1199999_L1.htm,19,19,5111,2480,2404,37,2441,25,14,2159,88.44,245,10.03
TIMBIO,CAUCA,http://www3.registraduria.gov.co/elecciones/elecciones2014/presidente/2v/99PR2/DPR1108899_L1.htm,http://www3.registraduria.gov.co/elecciones/elecciones2014/presidente/2v/99PR2/DPR1199999_L1.htm,66,66,23590,13372,12571,371,12942,370,60,7121,55.02,5450,42.11
TIMBIQUI,CAUCA,http://www3.registraduria.gov.co/elecciones/elecciones2014/presidente/2v/99PR2/DPR1109199_L1.htm,http://www3.registraduria.gov.co/elecciones/elecciones2014/presidente/2v/99PR2/DPR1199999_L1.htm,48,48,13709,6003,5901,40,5941,55,7,5329,89.69,572,9.62
TORIBIO,CAUCA,http://www3.registraduria.gov.co/elecciones/elecciones2014/presidente/2v/99PR2/DPR1109499_L1.htm,http://www3.registraduria.gov.co/elecciones/elecciones2014/presidente/2v/99PR2/DPR1199999_L1.htm,45,45,15697,9362,9040,114,9154,159,49,8406,91.82,634,6.92
TOTORO,CAUCA,http://www3.registraduria.gov.co/elecciones/elecciones2014/presidente/2v/99PR2/DPR1109799_L1.htm,http://www3.registraduria.gov.co/elecciones/elecciones2014/presidente/2v/99PR2/DPR1199999_L1.htm,30,30,9925,5007,4802,74,4876,83,48,4015,82.34,787,16.14
VILLA RICA,CAUCA,http://www3.registraduria.gov.co/elecciones/elecciones2014/presidente/2v/99PR2/DPR1109899_L1.htm,http://www3.registraduria.gov.co/elecciones/elecciones2014/presidente/2v/99PR2/DPR1199999_L1.htm,32,32,12124,7524,7265,100,7365,144,15,6611,89.76,654,8.87
AGUACHICA,CESAR,http://www3.registraduria.gov.co/elecciones/elecciones2014/presidente/2v/99PR2/DPR1207599_L1.htm,http://www3.registraduria.gov.co/elecciones/elecciones2014/presidente/2v/99PR2/DPR1299999_L1.htm,160,160,60268,32188,30714,798,31512,630,46,14932,47.38,15782,50.08
AGUSTIN CODAZZI,CESAR,http://www3.registraduria.gov.co/elecciones/elecciones2014/presidente/2v/99PR2/DPR1215099_L1.htm,http://www3.registraduria.gov.co/elecciones/elecciones2014/presidente/2v/99PR2/DPR1299999_L1.htm,98,98,41695,19043,18366,383,18749,244,50,10214,54.47,8152,43.47
ASTREA,CESAR,http://www3.registraduria.gov.co/elecciones/elecciones2014/presidente/2v/99PR2/DPR1217099_L1.htm,http://www3.registraduria.gov.co/elecciones/elecciones2014/presidente/2v/99PR2/DPR1299999_L1.htm,35,35,12844,6356,6225,60,6285,54,17,3532,56.19,2693,42.84
BECERRIL,CESAR,http://www3.registraduria.gov.co/elecciones/elecciones2014/presidente/2v/99PR2/DPR1218099_L1.htm,http://www3.registraduria.gov.co/elecciones/elecciones2014/presidente/2v/99PR2/DPR1299999_L1.htm,36,36,13375,6709,6489,120,6609,84,16,4834,73.14,1655,25.04
BOSCONIA,CESAR,http://www3.registraduria.gov.co/elecciones/elecciones2014/presidente/2v/99PR2/DPR1220099_L1.htm,http://www3.registraduria.gov.co/elecciones/elecciones2014/presidente/2v/99PR2/DPR1299999_L1.htm,65,65,24412,10738,10346,211,10557,160,21,5912,56.00,4434,42.00
CHIMICHAGUA,CESAR,http://www3.registraduria.gov.co/elecciones/elecciones2014/presidente/2v/99PR2/DPR1230099_L1.htm,http://www3.registraduria.gov.co/elecciones/elecciones2014/presidente/2v/99PR2/DPR1299999_L1.htm,72,72,22913,10639,10393,110,10503,104,32,6085,57.93,4308,41.01
CHIRIGUANA,CESAR,http://www3.registraduria.gov.co/elecciones/elecciones2014/presidente/2v/99PR2/DPR1237599_L1.htm,http://www3.registraduria.gov.co/elecciones/elecciones2014/presidente/2v/99PR2/DPR1299999_L1.htm,53,53,19212,9612,9330,117,9447,139,26,5499,58.20,3831,40.55
CURUMANI,CESAR,http://www3.registraduria.gov.co/elecciones/elecciones2014/presidente/2v/99PR2/DPR1222599_L1.htm,http://www3.registraduria.gov.co/elecciones/elecciones2014/presidente/2v/99PR2/DPR1299999_L1.htm,63,63,23403,11628,11303,177,11480,127,21,7851,68.38,3452,30.06
EL COPEY,CESAR,http://www3.registraduria.gov.co/elecciones/elecciones2014/presidente/2v/99PR2/DPR1241099_L1.htm,http://www3.registraduria.gov.co/elecciones/elecciones2014/presidente/2v/99PR2/DPR1299999_L1.htm,56,56,21152,10334,10017,181,10198,123,13,6665,65.35,3352,32.86
EL PASO,CESAR,http://www3.registraduria.gov.co/elecciones/elecciones2014/presidente/2v/99PR2/DPR1241599_L1.htm,http://www3.registraduria.gov.co/elecciones/elecciones2014/presidente/2v/99PR2/DPR1299999_L1.htm,48,48,17726,9006,8770,118,8888,105,13,6690,75.27,2080,23.40
GAMARRA,CESAR,http://www3.registraduria.gov.co/elecciones/elecciones2014/presidente/2v/99PR2/DPR1245099_L1.htm,http://www3.registraduria.gov.co/elecciones/elecciones2014/presidente/2v/99PR2/DPR1299999_L1.htm,29,29,9877,5311,5192,59,5251,52,8,3246,61.81,1946,37.05
GONZALEZ,CESAR,http://www3.registraduria.gov.co/elecciones/elecciones2014/presidente/2v/99PR2/DPR1252599_L1.htm,http://www3.registraduria.gov.co/elecciones/elecciones2014/presidente/2v/99PR2/DPR1299999_L1.htm,15,15,3940,1997,1914,50,1964,27,6,1329,67.66,585,29.78
LA GLORIA,CESAR,http://www3.registraduria.gov.co/elecciones/elecciones2014/presidente/2v/99PR2/DPR1260099_L1.htm,http://www3.registraduria.gov.co/elecciones/elecciones2014/presidente/2v/99PR2/DPR1299999_L1.htm,30,30,10139,5403,5253,68,5321,69,13,3258,61.22,1995,37.49
LA JAGUA DE IBIRICO,CESAR,http://www3.registraduria.gov.co/elecciones/elecciones2014/presidente/2v/99PR2/DPR1260899_L1.htm,http://www3.registraduria.gov.co/elecciones/elecciones2014/presidente/2v/99PR2/DPR1299999_L1.htm,57,57,21657,12683,12279,204,12483,187,13,10293,82.45,1986,15.90
LA PAZ,CESAR,http://www3.registraduria.gov.co/elecciones/elecciones2014/presidente/2v/99PR2/DPR1282599_L1.htm,http://www3.registraduria.gov.co/elecciones/elecciones2014/presidente/2v/99PR2/DPR1299999_L1.htm,50,50,18182,8134,7938,101,8039,81,14,4629,57.58,3309,41.16
MANAURE BALCON DEL CESAR (MANA,CESAR,http://www3.registraduria.gov.co/elecciones/elecciones2014/presidente/2v/99PR2/DPR1262599_L1.htm,http://www3.registraduria.gov.co/elecciones/elecciones2014/presidente/2v/99PR2/DPR1299999_L1.htm,20,20,6399,3593,3501,38,3539,44,10,2435,68.80,1066,30.12
PAILITAS,CESAR,http://www3.registraduria.gov.co/elecciones/elecciones2014/presidente/2v/99PR2/DPR1265099_L1.htm,http://www3.registraduria.gov.co/elecciones/elecciones2014/presidente/2v/99PR2/DPR1299999_L1.htm,36,36,13055,6888,6717,81,6798,76,14,5279,77.65,1438,21.15
PELAYA,CESAR,http://www3.registraduria.gov.co/elecciones/elecciones2014/presidente/2v/99PR2/DPR1270099_L1.htm,http://www3.registraduria.gov.co/elecciones/elecciones2014/presidente/2v/99PR2/DPR1299999_L1.htm,33,33,12570,6485,6292,106,6398,76,11,4095,64.00,2197,34.33
PUEBLO BELLO,CESAR,http://www3.registraduria.gov.co/elecciones/elecciones2014/presidente/2v/99PR2/DPR1272099_L1.htm,http://www3.registraduria.gov.co/elecciones/elecciones2014/presidente/2v/99PR2/DPR1299999_L1.htm,39,39,14106,5418,5216,76,5292,98,28,3349,63.28,1867,35.27
RIO DE ORO,CESAR,http://www3.registraduria.gov.co/elecciones/elecciones2014/presidente/2v/99PR2/DPR1275099_L1.htm,http://www3.registraduria.gov.co/elecciones/elecciones2014/presidente/2v/99PR2/DPR1299999_L1.htm,43,43,13965,6774,6497,151,6648,100,26,3585,53.92,2912,43.80
SAN ALBERTO,CESAR,http://www3.registraduria.gov.co/elecciones/elecciones2014/presidente/2v/99PR2/DPR1280099_L1.htm,http://www3.registraduria.gov.co/elecciones/elecciones2014/presidente/2v/99PR2/DPR1299999_L1.htm,47,47,17149,8221,7835,200,8035,160,26,4196,52.22,3639,45.28
SAN DIEGO,CESAR,http://www3.registraduria.gov.co/elecciones/elecciones2014/presidente/2v/99PR2/DPR1285099_L1.htm,http://www3.registraduria.gov.co/elecciones/elecciones2014/presidente/2v/99PR2/DPR1299999_L1.htm,36,36,12853,6660,6430,132,6562,82,16,3837,58.47,2593,39.51
SAN MARTIN,CESAR,http://www3.registraduria.gov.co/elecciones/elecciones2014/presidente/2v/99PR2/DPR1287599_L1.htm,http://www3.registraduria.gov.co/elecciones/elecciones2014/presidente/2v/99PR2/DPR1299999_L1.htm,39,39,13115,7649,7348,168,7516,120,13,3971,52.83,3377,44.93
TAMALAMEQUE,CESAR,http://www3.registraduria.gov.co/elecciones/elecciones2014/presidente/2v/99PR2/DPR1290099_L1.htm,http://www3.registraduria.gov.co/elecciones/elecciones2014/presidente/2v/99PR2/DPR1299999_L1.htm,29,29,9817,4938,4864,31,4895,38,5,3789,77.40,1075,21.96
VALLEDUPAR,CESAR,http://www3.registraduria.gov.co/elecciones/elecciones2014/presidente/2v/99PR2/DPR1200199_L1.htm,http://www3.registraduria.gov.co/elecciones/elecciones2014/presidente/2v/99PR2/DPR1299999_L1.htm,652,652,259852,120968,115679,3186,118865,1943,160,71857,60.45,43822,36.86
ACANDI,CHOCO,http://www3.registraduria.gov.co/elecciones/elecciones2014/presidente/2v/99PR2/DPR1700499_L1.htm,http://www3.registraduria.gov.co/elecciones/elecciones2014/presidente/2v/99PR2/DPR1799999_L1.htm,26,26,7918,3368,3280,46,3326,24,18,2342,70.41,938,28.20
ALTO BAUDO (PIE DE PATO),CHOCO,http://www3.registraduria.gov.co/elecciones/elecciones2014/presidente/2v/99PR2/DPR1700699_L1.htm,http://www3.registraduria.gov.co/elecciones/elecciones2014/presidente/2v/99PR2/DPR1799999_L1.htm,45,45,8974,1216,1187,13,1200,12,4,1055,87.91,132,11.00
ATRATO (YUTO),CHOCO,http://www3.registraduria.gov.co/elecciones/elecciones2014/presidente/2v/99PR2/DPR1700299_L1.htm,http://www3.registraduria.gov.co/elecciones/elecciones2014/presidente/2v/99PR2/DPR1799999_L1.htm,27,27,8722,3096,2940,68,3008,79,9,2006,66.68,934,31.05
BAGADO,CHOCO,http://www3.registraduria.gov.co/elecciones/elecciones2014/presidente/2v/99PR2/DPR1700799_L1.htm,http://www3.registraduria.gov.co/elecciones/elecciones2014/presidente/2v/99PR2/DPR1799999_L1.htm,27,27,8679,2254,2185,33,2218,24,12,1677,75.60,508,22.90
BAHIA SOLANO (MUTIS),CHOCO,http://www3.registraduria.gov.co/elecciones/elecciones2014/presidente/2v/99PR2/DPR1700899_L1.htm,http://www3.registraduria.gov.co/elecciones/elecciones2014/presidente/2v/99PR2/DPR1799999_L1.htm,22,22,6989,3009,2940,37,2977,25,7,2225,74.73,715,24.01
BAJO BAUDO (PIZARRO),CHOCO,http://www3.registraduria.gov.co/elecciones/elecciones2014/presidente/2v/99PR2/DPR1701099_L1.htm,http://www3.registraduria.gov.co/elecciones/elecciones2014/presidente/2v/99PR2/DPR1799999_L1.htm,31,31,9607,2581,2502,23,2525,36,20,1940,76.83,562,22.25
BOJAYA (BELLAVISTA),CHOCO,http://www3.registraduria.gov.co/elecciones/elecciones2014/presidente/2v/99PR2/DPR1701199_L1.htm,http://www3.registraduria.gov.co/elecciones/elecciones2014/presidente/2v/99PR2/DPR1799999_L1.htm,26,26,6585,2058,1990,10,2000,50,8,1640,82.00,350,17.50
CARMEN DEL DARIEN,CHOCO,http://www3.registraduria.gov.co/elecciones/elecciones2014/presidente/2v/99PR2/DPR1701599_L1.htm,http://www3.registraduria.gov.co/elecciones/elecciones2014/presidente/2v/99PR2/DPR1799999_L1.htm,17,17,5257,2343,2282,10,2292,40,11,2031,88.61,251,10.95
CERTEGUI,CHOCO,http://www3.registraduria.gov.co/elecciones/elecciones2014/presidente/2v/99PR2/DPR1701499_L1.htm,http://www3.registraduria.gov.co/elecciones/elecciones2014/presidente/2v/99PR2/DPR1799999_L1.htm,13,13,4044,1755,1645,46,1691,56,8,993,58.72,652,38.55
CONDOTO,CHOCO,http://www3.registraduria.gov.co/elecciones/elecciones2014/presidente/2v/99PR2/DPR1701399_L1.htm,http://www3.registraduria.gov.co/elecciones/elecciones2014/presidente/2v/99PR2/DPR1799999_L1.htm,36,36,10167,3199,2977,110,3087,87,25,1151,37.28,1826,59.15
EL CANTON DEL SAN PABLO (MAN.,CHOCO,http://www3.registraduria.gov.co/elecciones/elecciones2014/presidente/2v/99PR2/DPR1701799_L1.htm,http://www3.registraduria.gov.co/elecciones/elecciones2014/presidente/2v/99PR2/DPR1799999_L1.htm,14,14,4256,1509,1405,51,1456,43,10,775,53.22,630,43.26
EL CARMEN,CHOCO,http://www3.registraduria.gov.co/elecciones/elecciones2014/presidente/2v/99PR2/DPR1701699_L1.htm,http://www3.registraduria.gov.co/elecciones/elecciones2014/presidente/2v/99PR2/DPR1799999_L1.htm,16,16,5556,2315,2148,88,2236,61,18,1040,46.51,1108,49.55
EL LITORAL DEL SAN JUAN,CHOCO,http://www3.registraduria.gov.co/elecciones/elecciones2014/presidente/2v/99PR2/DPR1703899_L1.htm,http://www3.registraduria.gov.co/elecciones/elecciones2014/presidente/2v/99PR2/DPR1799999_L1.htm,25,25,6876,2779,2724,21,2745,28,6,2628,95.73,96,3.49
ISTMINA,CHOCO,http://www3.registraduria.gov.co/elecciones/elecciones2014/presidente/2v/99PR2/DPR1701999_L1.htm,http://www3.registraduria.gov.co/elecciones/elecciones2014/presidente/2v/99PR2/DPR1799999_L1.htm,59,59,20146,6530,6020,288,6308,166,56,2771,43.92,3249,51.50
JURADO,CHOCO,http://www3.registraduria.gov.co/elecciones/elecciones2014/presidente/2v/99PR2/DPR1702299_L1.htm,http://www3.registraduria.gov.co/elecciones/elecciones2014/presidente/2v/99PR2/DPR1799999_L1.htm,13,13,2866,897,875,15,890,6,1,600,67.41,275,30.89
LLORO,CHOCO,http://www3.registraduria.gov.co/elecciones/elecciones2014/presidente/2v/99PR2/DPR1702599_L1.htm,http://www3.registraduria.gov.co/elecciones/elecciones2014/presidente/2v/99PR2/DPR1799999_L1.htm,24,24,7397,2542,2418,35,2453,79,10,1668,67.99,750,30.57
MEDIO ATRATO (BETE),CHOCO,http://www3.registraduria.gov.co/elecciones/elecciones2014/presidente/2v/99PR2/DPR1701299_L1.htm,http://www3.registraduria.gov.co/elecciones/elecciones2014/presidente/2v/99PR2/DPR1799999_L1.htm,19,19,5670,1875,1818,16,1834,35,6,1480,80.69,338,18.42
MEDIO BAUDO (PUERTO MELUK),CHOCO,http://www3.registraduria.gov.co/elecciones/elecciones2014/presidente/2v/99PR2/DPR1702699_L1.htm,http://www3.registraduria.gov.co/elecciones/elecciones2014/presidente/2v/99PR2/DPR1799999_L1.htm,27,27,7044,2290,2198,31,2229,46,15,1422,63.79,776,34.81
MEDIO SAN JUAN,CHOCO,http://www3.registraduria.gov.co/elecciones/elecciones2014/presidente/2v/99PR2/DPR1702799_L1.htm,http://www3.registraduria.gov.co/elecciones/elecciones2014/presidente/2v/99PR2/DPR1799999_L1.htm,25,25,7376,1074,1009,33,1042,25,7,700,67.17,309,29.65
NOVITA,CHOCO,http://www3.registraduria.gov.co/elecciones/elecciones2014/presidente/2v/99PR2/DPR1702899_L1.htm,http://www3.registraduria.gov.co/elecciones/elecciones2014/presidente/2v/99PR2/DPR1799999_L1.htm,19,19,5055,1075,1005,25,1030,32,13,351,34.07,654,63.49
NUQUI,CHOCO,http://www3.registraduria.gov.co/elecciones/elecciones2014/presidente/2v/99PR2/DPR1703199_L1.htm,http://www3.registraduria.gov.co/elecciones/elecciones2014/presidente/2v/99PR2/DPR1799999_L1.htm,18,18,5282,1794,1756,11,1767,22,5,1455,82.34,301,17.03
QUIBDO,CHOCO,http://www3.registraduria.gov.co/elecciones/elecciones2014/presidente/2v/99PR2/DPR1700199_L1.htm,http://www3.registraduria.gov.co/elecciones/elecciones2014/presidente/2v/99PR2/DPR1799999_L1.htm,199,199,73678,30620,27875,1236,29111,1323,186,17055,58.58,10820,37.16
RIO IRO,CHOCO,http://www3.registraduria.gov.co/elecciones/elecciones2014/presidente/2v/99PR2/DPR1703299_L1.htm,http://www3.registraduria.gov.co/elecciones/elecciones2014/presidente/2v/99PR2/DPR1799999_L1.htm,14,14,3669,1288,1235,18,1253,24,11,832,66.40,403,32.16
RIO QUITO (PAIMADO),CHOCO,http://www3.registraduria.gov.co/elecciones/elecciones2014/presidente/2v/99PR2/DPR1703599_L1.htm,http://www3.registraduria.gov.co/elecciones/elecciones2014/presidente/2v/99PR2/DPR1799999_L1.htm,20,20,5885,3070,2910,43,2953,100,17,1935,65.52,975,33.01
RIOSUCIO,CHOCO,http://www3.registraduria.gov.co/elecciones/elecciones2014/presidente/2v/99PR2/DPR1703499_L1.htm,http://www3.registraduria.gov.co/elecciones/elecciones2014/presidente/2v/99PR2/DPR1799999_L1.htm,47,47,12863,4885,4769,39,4808,55,22,4091,85.08,678,14.10
SAN JOSE DEL PALMAR,CHOCO,http://www3.registraduria.gov.co/elecciones/elecciones2014/presidente/2v/99PR2/DPR1703799_L1.htm,http://www3.registraduria.gov.co/elecciones/elecciones2014/presidente/2v/99PR2/DPR1799999_L1.htm,22,22,4095,1085,1041,29,1070,10,5,733,68.50,308,28.78
SIPI,CHOCO,http://www3.registraduria.gov.co/elecciones/elecciones2014/presidente/2v/99PR2/DPR1704099_L1.htm,http://www3.registraduria.gov.co/elecciones/elecciones2014/presidente/2v/99PR2/DPR1799999_L1.htm,9,9,2405,171,151,11,162,8,1,48,29.62,103,63.58
TADO,CHOCO,http://www3.registraduria.gov.co/elecciones/elecciones2014/presidente/2v/99PR2/DPR1704399_L1.htm,http://www3.registraduria.gov.co/elecciones/elecciones2014/presidente/2v/99PR2/DPR1799999_L1.htm,36,36,11713,4944,4626,97,4723,192,29,2534,53.65,2092,44.29
UNGUIA,CHOCO,http://www3.registraduria.gov.co/elecciones/elecciones2014/presidente/2v/99PR2/DPR1704899_L1.htm,http://www3.registraduria.gov.co/elecciones/elecciones2014/presidente/2v/99PR2/DPR1799999_L1.htm,24,24,8167,2830,2708,63,2771,49,10,1763,63.62,945,34.10
UNION PANAMERICANA (LAS ANIMAS,CHOCO,http://www3.registraduria.gov.co/elecciones/elecciones2014/presidente/2v/99PR2/DPR1706099_L1.htm,http://www3.registraduria.gov.co/elecciones/elecciones2014/presidente/2v/99PR2/DPR1799999_L1.htm,15,15,4893,2232,2122,42,2164,58,10,911,42.09,1211,55.96
AYAPEL,CORDOBA,http://www3.registraduria.gov.co/elecciones/elecciones2014/presidente/2v/99PR2/DPR1300499_L1.htm,http://www3.registraduria.gov.co/elecciones/elecciones2014/presidente/2v/99PR2/DPR1399999_L1.htm,85,85,31026,14291,13966,145,14111,148,32,8291,58.75,5675,40.21
BUENAVISTA,CORDOBA,http://www3.registraduria.gov.co/elecciones/elecciones2014/presidente/2v/99PR2/DPR1300799_L1.htm,http://www3.registraduria.gov.co/elecciones/elecciones2014/presidente/2v/99PR2/DPR1399999_L1.htm,50,50,17636,8505,8351,85,8436,50,19,6601,78.24,1750,20.74
CANALETE,CORDOBA,http://www3.registraduria.gov.co/elecciones/elecciones2014/presidente/2v/99PR2/DPR1300999_L1.htm,http://www3.registraduria.gov.co/elecciones/elecciones2014/presidente/2v/99PR2/DPR1399999_L1.htm,45,45,15668,7014,6904,50,6954,48,12,5353,76.97,1551,22.30
CERETE,CORDOBA,http://www3.registraduria.gov.co/elecciones/elecciones2014/presidente/2v/99PR2/DPR1301099_L1.htm,http://www3.registraduria.gov.co/elecciones/elecciones2014/presidente/2v/99PR2/DPR1399999_L1.htm,173,173,68558,37249,35858,774,36632,551,66,20336,55.51,15522,42.37
CHIMA,CORDOBA,http://www3.registraduria.gov.co/elecciones/elecciones2014/presidente/2v/99PR2/DPR1301699_L1.htm,http://www3.registraduria.gov.co/elecciones/elecciones2014/presidente/2v/99PR2/DPR1399999_L1.htm,36,36,12491,6653,6575,28,6603,39,11,4808,72.81,1767,26.76
CHINU,CORDOBA,http://www3.registraduria.gov.co/elecciones/elecciones2014/presidente/2v/99PR2/DPR1301999_L1.htm,http://www3.registraduria.gov.co/elecciones/elecciones2014/presidente/2v/99PR2/DPR1399999_L1.htm,101,101,33856,20536,19894,256,20150,344,42,11438,56.76,8456,41.96
CIENAGA DE ORO,CORDOBA,http://www3.registraduria.gov.co/elecciones/elecciones2014/presidente/2v/99PR2/DPR1301399_L1.htm,http://www3.registraduria.gov.co/elecciones/elecciones2014/presidente/2v/99PR2/DPR1399999_L1.htm,98,98,40078,20841,20166,316,20482,278,81,12601,61.52,7565,36.93
COTORRA (BONGO),CORDOBA,http://www3.registraduria.gov.co/elecciones/elecciones2014/presidente/2v/99PR2/DPR1301499_L1.htm,http://www3.registraduria.gov.co/elecciones/elecciones2014/presidente/2v/99PR2/DPR1399999_L1.htm,37,37,13103,8131,7969,74,8043,56,32,4327,53.79,3642,45.28
LA APARTADA (FRONTERA),CORDOBA,http://www3.registraduria.gov.co/elecciones/elecciones2014/presidente/2v/99PR2/DPR1302099_L1.htm,http://www3.registraduria.gov.co/elecciones/elecciones2014/presidente/2v/99PR2/DPR1399999_L1.htm,34,34,12801,5999,5820,88,5908,63,28,4644,78.60,1176,19.90
LORICA,CORDOBA,http://www3.registraduria.gov.co/elecciones/elecciones2014/presidente/2v/99PR2/DPR1302299_L1.htm,http://www3.registraduria.gov.co/elecciones/elecciones2014/presidente/2v/99PR2/DPR1399999_L1.htm,217,217,80807,46034,44971,574,45545,421,68,31871,69.97,13100,28.76
LOS CORDOBAS,CORDOBA,http://www3.registraduria.gov.co/elecciones/elecciones2014/presidente/2v/99PR2/DPR1302399_L1.htm,http://www3.registraduria.gov.co/elecciones/elecciones2014/presidente/2v/99PR2/DPR1399999_L1.htm,38,38,13167,6574,6455,43,6498,59,17,4485,69.02,1970,30.31
MOMIL,CORDOBA,http://www3.registraduria.gov.co/elecciones/elecciones2014/presidente/2v/99PR2/DPR1302499_L1.htm,http://www3.registraduria.gov.co/elecciones/elecciones2014/presidente/2v/99PR2/DPR1399999_L1.htm,35,35,12514,7212,7078,85,7163,31,18,4825,67.36,2253,31.45
MONTELIBANO,CORDOBA,http://www3.registraduria.gov.co/elecciones/elecciones2014/presidente/2v/99PR2/DPR1302599_L1.htm,http://www3.registraduria.gov.co/elecciones/elecciones2014/presidente/2v/99PR2/DPR1399999_L1.htm,126,126,52228,26569,25624,563,26187,302,80,20941,79.96,4683,17.88
MONTERIA,CORDOBA,http://www3.registraduria.gov.co/elecciones/elecciones2014/presidente/2v/99PR2/DPR1300199_L1.htm,http://www3.registraduria.gov.co/elecciones/elecciones2014/presidente/2v/99PR2/DPR1399999_L1.htm,715,715,285538,141349,136145,3047,139192,1874,283,64071,46.03,72074,51.78
MOÑITOS,CORDOBA,http://www3.registraduria.gov.co/elecciones/elecciones2014/presidente/2v/99PR2/DPR1302799_L1.htm,http://www3.registraduria.gov.co/elecciones/elecciones2014/presidente/2v/99PR2/DPR1399999_L1.htm,50,50,17586,9056,8885,58,8943,74,39,5683,63.54,3202,35.80
PLANETA RICA,CORDOBA,http://www3.registraduria.gov.co/elecciones/elecciones2014/presidente/2v/99PR2/DPR1302899_L1.htm,http://www3.registraduria.gov.co/elecciones/elecciones2014/presidente/2v/99PR2/DPR1399999_L1.htm,120,120,50770,26024,25255,394,25649,297,78,18056,70.39,7199,28.06
PUEBLO NUEVO,CORDOBA,http://www3.registraduria.gov.co/elecciones/elecciones2014/presidente/2v/99PR2/DPR1303199_L1.htm,http://www3.registraduria.gov.co/elecciones/elecciones2014/presidente/2v/99PR2/DPR1399999_L1.htm,69,69,22661,13337,13069,144,13213,79,45,9657,73.08,3412,25.82
PUERTO ESCONDIDO,CORDOBA,http://www3.registraduria.gov.co/elecciones/elecciones2014/presidente/2v/99PR2/DPR1303399_L1.htm,http://www3.registraduria.gov.co/elecciones/elecciones2014/presidente/2v/99PR2/DPR1399999_L1.htm,51,51,17415,8533,8367,54,8421,82,30,5837,69.31,2530,30.04
PUERTO LIBERTADOR,CORDOBA,http://www3.registraduria.gov.co/elecciones/elecciones2014/presidente/2v/99PR2/DPR1303299_L1.htm,http://www3.registraduria.gov.co/elecciones/elecciones2014/presidente/2v/99PR2/DPR1399999_L1.htm,69,69,24405,12733,12464,120,12584,131,18,10924,86.80,1540,12.23
PURISIMA,CORDOBA,http://www3.registraduria.gov.co/elecciones/elecciones2014/presidente/2v/99PR2/DPR1303499_L1.htm,http://www3.registraduria.gov.co/elecciones/elecciones2014/presidente/2v/99PR2/DPR1399999_L1.htm,35,35,13040,7461,7276,89,7365,60,36,4719,64.07,2557,34.71
SAHAGUN,CORDOBA,http://www3.registraduria.gov.co/elecciones/elecciones2014/presidente/2v/99PR2/DPR1303799_L1.htm,http://www3.registraduria.gov.co/elecciones/elecciones2014/presidente/2v/99PR2/DPR1399999_L1.htm,205,205,76537,42236,41318,463,41781,394,61,31829,76.18,9489,22.71
SAN ANDRES DE SOTAVENTO,CORDOBA,http://www3.registraduria.gov.co/elecciones/elecciones2014/presidente/2v/99PR2/DPR1304099_L1.htm,http://www3.registraduria.gov.co/elecciones/elecciones2014/presidente/2v/99PR2/DPR1399999_L1.htm,74,74,26668,16831,16527,85,16612,153,66,13167,79.26,3360,20.22
SAN ANTERO,CORDOBA,http://www3.registraduria.gov.co/elecciones/elecciones2014/presidente/2v/99PR2/DPR1304399_L1.htm,http://www3.registraduria.gov.co/elecciones/elecciones2014/presidente/2v/99PR2/DPR1399999_L1.htm,55,55,19994,11651,11379,131,11510,115,26,7956,69.12,3423,29.73
SAN BERNARDO DEL VIENTO,CORDOBA,http://www3.registraduria.gov.co/elecciones/elecciones2014/presidente/2v/99PR2/DPR1304699_L1.htm,http://www3.registraduria.gov.co/elecciones/elecciones2014/presidente/2v/99PR2/DPR1399999_L1.htm,76,76,25832,13243,13013,98,13111,100,32,9312,71.02,3701,28.22
SAN CARLOS,CORDOBA,http://www3.registraduria.gov.co/elecciones/elecciones2014/presidente/2v/99PR2/DPR1304999_L1.htm,http://www3.registraduria.gov.co/elecciones/elecciones2014/presidente/2v/99PR2/DPR1399999_L1.htm,52,52,19432,8330,8086,103,8189,118,23,4623,56.45,3463,42.28
SAN JOSE DE URE,CORDOBA,http://www3.registraduria.gov.co/elecciones/elecciones2014/presidente/2v/99PR2/DPR1305299_L1.htm,http://www3.registraduria.gov.co/elecciones/elecciones2014/presidente/2v/99PR2/DPR1399999_L1.htm,22,22,6928,3835,3765,35,3800,23,12,3274,86.15,491,12.92
SAN PELAYO,CORDOBA,http://www3.registraduria.gov.co/elecciones/elecciones2014/presidente/2v/99PR2/DPR1305599_L1.htm,http://www3.registraduria.gov.co/elecciones/elecciones2014/presidente/2v/99PR2/DPR1399999_L1.htm,96,96,34841,18589,18215,186,18401,176,12,11971,65.05,6244,33.93
TIERRALTA,CORDOBA,http://www3.registraduria.gov.co/elecciones/elecciones2014/presidente/2v/99PR2/DPR1305899_L1.htm,http://www3.registraduria.gov.co/elecciones/elecciones2014/presidente/2v/99PR2/DPR1399999_L1.htm,142,142,57470,24890,24127,356,24483,310,97,17602,71.89,6525,26.65
TUCHIN,CORDOBA,http://www3.registraduria.gov.co/elecciones/elecciones2014/presidente/2v/99PR2/DPR1306099_L1.htm,http://www3.registraduria.gov.co/elecciones/elecciones2014/presidente/2v/99PR2/DPR1399999_L1.htm,54,54,19690,12741,12376,64,12440,243,58,8298,66.70,4078,32.78
VALENCIA,CORDOBA,http://www3.registraduria.gov.co/elecciones/elecciones2014/presidente/2v/99PR2/DPR1306199_L1.htm,http://www3.registraduria.gov.co/elecciones/elecciones2014/presidente/2v/99PR2/DPR1399999_L1.htm,68,68,24420,13445,13147,129,13276,106,63,9152,68.93,3995,30.09
AGUA DE DIOS,CUNDINAMARCA,http://www3.registraduria.gov.co/elecciones/elecciones2014/presidente/2v/99PR2/DPR1500499_L1.htm,http://www3.registraduria.gov.co/elecciones/elecciones2014/presidente/2v/99PR2/DPR1599999_L1.htm,24,24,9407,5192,4902,147,5049,125,18,2975,58.92,1927,38.16
ALBAN,CUNDINAMARCA,http://www3.registraduria.gov.co/elecciones/elecciones2014/presidente/2v/99PR2/DPR1500799_L1.htm,http://www3.registraduria.gov.co/elecciones/elecciones2014/presidente/2v/99PR2/DPR1599999_L1.htm,13,13,4795,2480,2319,75,2394,85,1,682,28.48,1637,68.37
ANAPOIMA,CUNDINAMARCA,http://www3.registraduria.gov.co/elecciones/elecciones2014/presidente/2v/99PR2/DPR1501099_L1.htm,http://www3.registraduria.gov.co/elecciones/elecciones2014/presidente/2v/99PR2/DPR1599999_L1.htm,28,28,10626,6030,5850,106,5956,63,11,2159,36.24,3691,61.97
ANOLAIMA,CUNDINAMARCA,http://www3.registraduria.gov.co/elecciones/elecciones2014/presidente/2v/99PR2/DPR1501399_L1.htm,http://www3.registraduria.gov.co/elecciones/elecciones2014/presidente/2v/99PR2/DPR1599999_L1.htm,29,29,11067,5578,5284,155,5439,119,20,1896,34.85,3388,62.29
APULO,CUNDINAMARCA,http://www3.registraduria.gov.co/elecciones/elecciones2014/presidente/2v/99PR2/DPR1521799_L1.htm,http://www3.registraduria.gov.co/elecciones/elecciones2014/presidente/2v/99PR2/DPR1599999_L1.htm,18,18,6717,3923,3813,47,3860,51,12,1773,45.93,2040,52.84
ARBELAEZ,CUNDINAMARCA,http://www3.registraduria.gov.co/elecciones/elecciones2014/presidente/2v/99PR2/DPR1501699_L1.htm,http://www3.registraduria.gov.co/elecciones/elecciones2014/presidente/2v/99PR2/DPR1599999_L1.htm,22,22,8300,4790,4504,180,4684,96,10,1177,25.12,3327,71.02
BELTRAN,CUNDINAMARCA,http://www3.registraduria.gov.co/elecciones/elecciones2014/presidente/2v/99PR2/DPR1501999_L1.htm,http://www3.registraduria.gov.co/elecciones/elecciones2014/presidente/2v/99PR2/DPR1599999_L1.htm,7,7,2003,937,907,12,919,17,1,451,49.07,456,49.61
BITUIMA,CUNDINAMARCA,http://www3.registraduria.gov.co/elecciones/elecciones2014/presidente/2v/99PR2/DPR1502299_L1.htm,http://www3.registraduria.gov.co/elecciones/elecciones2014/presidente/2v/99PR2/DPR1599999_L1.htm,8,8,2844,1250,1203,19,1222,25,3,447,36.57,756,61.86
BOJACA,CUNDINAMARCA,http://www3.registraduria.gov.co/elecciones/elecciones2014/presidente/2v/99PR2/DPR1502599_L1.htm,http://www3.registraduria.gov.co/elecciones/elecciones2014/presidente/2v/99PR2/DPR1599999_L1.htm,14,14,5315,3599,3303,127,3430,159,10,1618,47.17,1685,49.12
CABRERA,CUNDINAMARCA,http://www3.registraduria.gov.co/elecciones/elecciones2014/presidente/2v/99PR2/DPR1502999_L1.htm,http://www3.registraduria.gov.co/elecciones/elecciones2014/presidente/2v/99PR2/DPR1599999_L1.htm,9,9,3282,1581,1516,32,1548,27,6,1023,66.08,493,31.84
CACHIPAY,CUNDINAMARCA,http://www3.registraduria.gov.co/elecciones/elecciones2014/presidente/2v/99PR2/DPR1503099_L1.htm,http://www3.registraduria.gov.co/elecciones/elecciones2014/presidente/2v/99PR2/DPR1599999_L1.htm,23,23,8509,4564,4331,121,4452,98,14,2108,47.34,2223,49.93
CAJICA,CUNDINAMARCA,http://www3.registraduria.gov.co/elecciones/elecciones2014/presidente/2v/99PR2/DPR1503199_L1.htm,http://www3.registraduria.gov.co/elecciones/elecciones2014/presidente/2v/99PR2/DPR1599999_L1.htm,91,91,34539,20290,18115,1191,19306,951,33,9096,47.11,9019,46.71
CAPARRAPI,CUNDINAMARCA,http://www3.registraduria.gov.co/elecciones/elecciones2014/presidente/2v/99PR2/DPR1503499_L1.htm,http://www3.registraduria.gov.co/elecciones/elecciones2014/presidente/2v/99PR2/DPR1599999_L1.htm,32,32,10272,4795,4584,100,4684,78,33,1304,27.83,3280,70.02
CAQUEZA,CUNDINAMARCA,http://www3.registraduria.gov.co/elecciones/elecciones2014/presidente/2v/99PR2/DPR1503799_L1.htm,http://www3.registraduria.gov.co/elecciones/elecciones2014/presidente/2v/99PR2/DPR1599999_L1.htm,36,36,14097,7524,7099,206,7305,202,17,1964,26.88,5135,70.29
CARMEN DE CARUPA,CUNDINAMARCA,http://www3.registraduria.gov.co/elecciones/elecciones2014/presidente/2v/99PR2/DPR1504099_L1.htm,http://www3.registraduria.gov.co/elecciones/elecciones2014/presidente/2v/99PR2/DPR1599999_L1.htm,17,17,6025,3215,3016,99,3115,83,17,714,22.92,2302,73.90
CHAGUANI,CUNDINAMARCA,http://www3.registraduria.gov.co/elecciones/elecciones2014/presidente/2v/99PR2/DPR1505299_L1.htm,http://www3.registraduria.gov.co/elecciones/elecciones2014/presidente/2v/99PR2/DPR1599999_L1.htm,10,10,3725,1678,1632,24,1656,16,6,506,30.55,1126,67.99
CHIA,CUNDINAMARCA,http://www3.registraduria.gov.co/elecciones/elecciones2014/presidente/2v/99PR2/DPR1505599_L1.htm,http://www3.registraduria.gov.co/elecciones/elecciones2014/presidente/2v/99PR2/DPR1599999_L1.htm,178,178,77779,45356,41076,2630,43706,1606,44,20410,46.69,20666,47.28
CHIPAQUE,CUNDINAMARCA,http://www3.registraduria.gov.co/elecciones/elecciones2014/presidente/2v/99PR2/DPR1505899_L1.htm,http://www3.registraduria.gov.co/elecciones/elecciones2014/presidente/2v/99PR2/DPR1599999_L1.htm,18,18,6993,4150,3974,88,4062,84,4,861,21.19,3113,76.63
CHOACHI,CUNDINAMARCA,http://www3.registraduria.gov.co/elecciones/elecciones2014/presidente/2v/99PR2/DPR1506199_L1.htm,http://www3.registraduria.gov.co/elecciones/elecciones2014/presidente/2v/99PR2/DPR1599999_L1.htm,30,30,11062,6159,5775,236,6011,135,13,1314,21.85,4461,74.21
CHOCONTA,CUNDINAMARCA,http://www3.registraduria.gov.co/elecciones/elecciones2014/presidente/2v/99PR2/DPR1506499_L1.htm,http://www3.registraduria.gov.co/elecciones/elecciones2014/presidente/2v/99PR2/DPR1599999_L1.htm,36,36,13526,7857,7288,299,7587,246,24,2369,31.22,4919,64.83
COGUA,CUNDINAMARCA,http://www3.registraduria.gov.co/elecciones/elecciones2014/presidente/2v/99PR2/DPR1504399_L1.htm,http://www3.registraduria.gov.co/elecciones/elecciones2014/presidente/2v/99PR2/DPR1599999_L1.htm,32,32,12219,7398,6708,365,7073,308,17,3057,43.22,3651,51.61
COTA,CUNDINAMARCA,http://www3.registraduria.gov.co/elecciones/elecciones2014/presidente/2v/99PR2/DPR1504699_L1.htm,http://www3.registraduria.gov.co/elecciones/elecciones2014/presidente/2v/99PR2/DPR1599999_L1.htm,53,53,20752,11275,10300,565,10865,397,13,4777,43.96,5523,50.83
CUCUNUBA,CUNDINAMARCA,http://www3.registraduria.gov.co/elecciones/elecciones2014/presidente/2v/99PR2/DPR1504999_L1.htm,http://www3.registraduria.gov.co/elecciones/elecciones2014/presidente/2v/99PR2/DPR1599999_L1.htm,13,13,4530,2881,2653,114,2767,108,6,740,26.74,1913,69.13
EL COLEGIO,CUNDINAMARCA,http://www3.registraduria.gov.co/elecciones/elecciones2014/presidente/2v/99PR2/DPR1506799_L1.htm,http://www3.registraduria.gov.co/elecciones/elecciones2014/presidente/2v/99PR2/DPR1599999_L1.htm,49,49,18346,9608,9224,189,9413,169,26,3865,41.06,5359,56.93
EL PEÑON,CUNDINAMARCA,http://www3.registraduria.gov.co/elecciones/elecciones2014/presidente/2v/99PR2/DPR1507099_L1.htm,http://www3.registraduria.gov.co/elecciones/elecciones2014/presidente/2v/99PR2/DPR1599999_L1.htm,13,13,4283,2093,2026,31,2057,14,22,354,17.20,1672,81.28
EL ROSAL,CUNDINAMARCA,http://www3.registraduria.gov.co/elecciones/elecciones2014/presidente/2v/99PR2/DPR1507299_L1.htm,http://www3.registraduria.gov.co/elecciones/elecciones2014/presidente/2v/99PR2/DPR1599999_L1.htm,32,32,12280,8710,7868,398,8266,424,20,2074,25.09,5794,70.09
FACATATIVA,CUNDINAMARCA,http://www3.registraduria.gov.co/elecciones/elecciones2014/presidente/2v/99PR2/DPR1507699_L1.htm,http://www3.registraduria.gov.co/elecciones/elecciones2014/presidente/2v/99PR2/DPR1599999_L1.htm,200,200,80720,48613,42692,2858,45550,3006,57,18091,39.71,24601,54.00
FOMEQUE,CUNDINAMARCA,http://www3.registraduria.gov.co/elecciones/elecciones2014/presidente/2v/99PR2/DPR1507999_L1.htm,http://www3.registraduria.gov.co/elecciones/elecciones2014/presidente/2v/99PR2/DPR1599999_L1.htm,25,25,9188,5627,5391,125,5516,87,24,1082,19.61,4309,78.11
FOSCA,CUNDINAMARCA,http://www3.registraduria.gov.co/elecciones/elecciones2014/presidente/2v/99PR2/DPR1508599_L1.htm,http://www3.registraduria.gov.co/elecciones/elecciones2014/presidente/2v/99PR2/DPR1599999_L1.htm,15,15,5353,2958,2871,47,2918,34,6,414,14.18,2457,84.20
FUNZA,CUNDINAMARCA,http://www3.registraduria.gov.co/elecciones/elecciones2014/presidente/2v/99PR2/DPR1508899_L1.htm,http://www3.registraduria.gov.co/elecciones/elecciones2014/presidente/2v/99PR2/DPR1599999_L1.htm,134,134,55981,33532,29981,1890,31871,1629,32,15374,48.23,14607,45.83
FUQUENE,CUNDINAMARCA,http://www3.registraduria.gov.co/elecciones/elecciones2014/presidente/2v/99PR2/DPR1509199_L1.htm,http://www3.registraduria.gov.co/elecciones/elecciones2014/presidente/2v/99PR2/DPR1599999_L1.htm,10,10,3690,2013,1860,79,1939,65,9,872,44.97,988,50.95
FUSAGASUGA,CUNDINAMARCA,http://www3.registraduria.gov.co/elecciones/elecciones2014/presidente/2v/99PR2/DPR1509499_L1.htm,http://www3.registraduria.gov.co/elecciones/elecciones2014/presidente/2v/99PR2/DPR1599999_L1.htm,230,230,91223,49501,45842,1978,47820,1620,61,17474,36.54,28368,59.32
GACHALA,CUNDINAMARCA,http://www3.registraduria.gov.co/elecciones/elecciones2014/presidente/2v/99PR2/DPR1509799_L1.htm,http://www3.registraduria.gov.co/elecciones/elecciones2014/presidente/2v/99PR2/DPR1599999_L1.htm,15,15,5076,2313,2219,57,2276,29,8,1019,44.77,1200,52.72
GACHANCIPA,CUNDINAMARCA,http://www3.registraduria.gov.co/elecciones/elecciones2014/presidente/2v/99PR2/DPR1510099_L1.htm,http://www3.registraduria.gov.co/elecciones/elecciones2014/presidente/2v/99PR2/DPR1599999_L1.htm,22,22,8519,5353,4759,280,5039,297,17,2804,55.64,1955,38.79
GACHETA,CUNDINAMARCA,http://www3.registraduria.gov.co/elecciones/elecciones2014/presidente/2v/99PR2/DPR1510399_L1.htm,http://www3.registraduria.gov.co/elecciones/elecciones2014/presidente/2v/99PR2/DPR1599999_L1.htm,25,25,9198,4433,4210,113,4323,85,25,1172,27.11,3038,70.27
GAMA,CUNDINAMARCA,http://www3.registraduria.gov.co/elecciones/elecciones2014/presidente/2v/99PR2/DPR1510699_L1.htm,http://www3.registraduria.gov.co/elecciones/elecciones2014/presidente/2v/99PR2/DPR1599999_L1.htm,8,8,3045,1490,1431,26,1457,29,4,444,30.47,987,67.74
GIRARDOT,CUNDINAMARCA,http://www3.registraduria.gov.co/elecciones/elecciones2014/presidente/2v/99PR2/DPR1510999_L1.htm,http://www3.registraduria.gov.co/elecciones/elecciones2014/presidente/2v/99PR2/DPR1599999_L1.htm,197,197,79200,42133,39296,1535,40831,1257,45,20570,50.37,18726,45.86
GRANADA,CUNDINAMARCA,http://www3.registraduria.gov.co/elecciones/elecciones2014/presidente/2v/99PR2/DPR1513299_L1.htm,http://www3.registraduria.gov.co/elecciones/elecciones2014/presidente/2v/99PR2/DPR1599999_L1.htm,14,14,5442,3053,2825,107,2932,113,8,1011,34.48,1814,61.86
GUACHETA,CUNDINAMARCA,http://www3.registraduria.gov.co/elecciones/elecciones2014/presidente/2v/99PR2/DPR1511299_L1.htm,http://www3.registraduria.gov.co/elecciones/elecciones2014/presidente/2v/99PR2/DPR1599999_L1.htm,22,22,8306,4279,3795,256,4051,207,21,1411,34.83,2384,58.84
GUADUAS,CUNDINAMARCA,http://www3.registraduria.gov.co/elecciones/elecciones2014/presidente/2v/99PR2/DPR1511599_L1.htm,http://www3.registraduria.gov.co/elecciones/elecciones2014/presidente/2v/99PR2/DPR1599999_L1.htm,60,60,21444,10637,9904,395,10299,294,44,3862,37.49,6042,58.66
GUASCA,CUNDINAMARCA,http://www3.registraduria.gov.co/elecciones/elecciones2014/presidente/2v/99PR2/DPR1511899_L1.htm,http://www3.registraduria.gov.co/elecciones/elecciones2014/presidente/2v/99PR2/DPR1599999_L1.htm,25,25,9617,5340,4886,265,5151,179,10,1613,31.31,3273,63.54
GUATAQUI,CUNDINAMARCA,http://www3.registraduria.gov.co/elecciones/elecciones2014/presidente/2v/99PR2/DPR1512199_L1.htm,http://www3.registraduria.gov.co/elecciones/elecciones2014/presidente/2v/99PR2/DPR1599999_L1.htm,6,6,2086,1031,1002,9,1011,12,8,543,53.70,459,45.40
GUATAVITA,CUNDINAMARCA,http://www3.registraduria.gov.co/elecciones/elecciones2014/presidente/2v/99PR2/DPR1512499_L1.htm,http://www3.registraduria.gov.co/elecciones/elecciones2014/presidente/2v/99PR2/DPR1599999_L1.htm,13,13,4747,2721,2497,139,2636,81,4,760,28.83,1737,65.89
GUAYABAL DE SIQUIMA,CUNDINAMARCA,http://www3.registraduria.gov.co/elecciones/elecciones2014/presidente/2v/99PR2/DPR1512799_L1.htm,http://www3.registraduria.gov.co/elecciones/elecciones2014/presidente/2v/99PR2/DPR1599999_L1.htm,9,9,3524,2021,1937,51,1988,33,0,540,27.16,1397,70.27
GUAYABETAL,CUNDINAMARCA,http://www3.registraduria.gov.co/elecciones/elecciones2014/presidente/2v/99PR2/DPR1512899_L1.htm,http://www3.registraduria.gov.co/elecciones/elecciones2014/presidente/2v/99PR2/DPR1599999_L1.htm,12,12,4285,2530,2420,64,2484,39,7,401,16.14,2019,81.28
GUTIERREZ,CUNDINAMARCA,http://www3.registraduria.gov.co/elecciones/elecciones2014/presidente/2v/99PR2/DPR1513099_L1.htm,http://www3.registraduria.gov.co/elecciones/elecciones2014/presidente/2v/99PR2/DPR1599999_L1.htm,7,7,2631,1671,1633,25,1658,11,2,214,12.90,1419,85.58
JERUSALEN,CUNDINAMARCA,http://www3.registraduria.gov.co/elecciones/elecciones2014/presidente/2v/99PR2/DPR1513399_L1.htm,http://www3.registraduria.gov.co/elecciones/elecciones2014/presidente/2v/99PR2/DPR1599999_L1.htm,7,7,2709,1243,1224,7,1231,11,1,442,35.90,782,63.52
JUNIN,CUNDINAMARCA,http://www3.registraduria.gov.co/elecciones/elecciones2014/presidente/2v/99PR2/DPR1513699_L1.htm,http://www3.registraduria.gov.co/elecciones/elecciones2014/presidente/2v/99PR2/DPR1599999_L1.htm,16,16,5483,2698,2570,56,2626,55,17,740,28.17,1830,69.68
LA CALERA,CUNDINAMARCA,http://www3.registraduria.gov.co/elecciones/elecciones2014/presidente/2v/99PR2/DPR1513999_L1.htm,http://www3.registraduria.gov.co/elecciones/elecciones2014/presidente/2v/99PR2/DPR1599999_L1.htm,51,51,19108,10496,9548,583,10131,352,13,4785,47.23,4763,47.01
LA MESA,CUNDINAMARCA,http://www3.registraduria.gov.co/elecciones/elecciones2014/presidente/2v/99PR2/DPR1514299_L1.htm,http://www3.registraduria.gov.co/elecciones/elecciones2014/presidente/2v/99PR2/DPR1599999_L1.htm,61,61,22404,11887,11359,306,11665,203,19,5147,44.12,6212,53.25
LA PALMA,CUNDINAMARCA,http://www3.registraduria.gov.co/elecciones/elecciones2014/presidente/2v/99PR2/DPR1514599_L1.htm,http://www3.registraduria.gov.co/elecciones/elecciones2014/presidente/2v/99PR2/DPR1599999_L1.htm,23,23,8665,3741,3589,55,3644,66,31,1811,49.69,1778,48.79
LA PEÑA,CUNDINAMARCA,http://www3.registraduria.gov.co/elecciones/elecciones2014/presidente/2v/99PR2/DPR1514899_L1.htm,http://www3.registraduria.gov.co/elecciones/elecciones2014/presidente/2v/99PR2/DPR1599999_L1.htm,14,14,5503,3171,3050,56,3106,35,30,376,12.10,2674,86.09
LA VEGA,CUNDINAMARCA,http://www3.registraduria.gov.co/elecciones/elecciones2014/presidente/2v/99PR2/DPR1515199_L1.htm,http://www3.registraduria.gov.co/elecciones/elecciones2014/presidente/2v/99PR2/DPR1599999_L1.htm,31,31,11652,6559,6165,210,6375,161,23,2297,36.03,3868,60.67
LENGUAZAQUE,CUNDINAMARCA,http://www3.registraduria.gov.co/elecciones/elecciones2014/presidente/2v/99PR2/DPR1515499_L1.htm,http://www3.registraduria.gov.co/elecciones/elecciones2014/presidente/2v/99PR2/DPR1599999_L1.htm,17,17,6606,3907,3659,145,3804,97,6,574,15.08,3085,81.09
MACHETA,CUNDINAMARCA,http://www3.registraduria.gov.co/elecciones/elecciones2014/presidente/2v/99PR2/DPR1515799_L1.htm,http://www3.registraduria.gov.co/elecciones/elecciones2014/presidente/2v/99PR2/DPR1599999_L1.htm,16,16,6157,3044,2883,91,2974,60,10,726,24.41,2157,72.52
MADRID,CUNDINAMARCA,http://www3.registraduria.gov.co/elecciones/elecciones2014/presidente/2v/99PR2/DPR1516099_L1.htm,http://www3.registraduria.gov.co/elecciones/elecciones2014/presidente/2v/99PR2/DPR1599999_L1.htm,117,117,49707,29168,25475,1757,27232,1893,43,11592,42.56,13883,50.98
MANTA,CUNDINAMARCA,http://www3.registraduria.gov.co/elecciones/elecciones2014/presidente/2v/99PR2/DPR1516399_L1.htm,http://www3.registraduria.gov.co/elecciones/elecciones2014/presidente/2v/99PR2/DPR1599999_L1.htm,11,11,4020,2402,2302,64,2366,18,18,832,35.16,1470,62.13
MEDINA,CUNDINAMARCA,http://www3.registraduria.gov.co/elecciones/elecciones2014/presidente/2v/99PR2/DPR1516699_L1.htm,http://www3.registraduria.gov.co/elecciones/elecciones2014/presidente/2v/99PR2/DPR1599999_L1.htm,22,22,6728,3728,3594,73,3667,44,17,902,24.59,2692,73.41
MOSQUERA,CUNDINAMARCA,http://www3.registraduria.gov.co/elecciones/elecciones2014/presidente/2v/99PR2/DPR1516999_L1.htm,http://www3.registraduria.gov.co/elecciones/elecciones2014/presidente/2v/99PR2/DPR1599999_L1.htm,133,133,51230,30811,27754,1641,29395,1372,44,13664,46.48,14090,47.93
NARIÑO,CUNDINAMARCA,http://www3.registraduria.gov.co/elecciones/elecciones2014/presidente/2v/99PR2/DPR1517299_L1.htm,http://www3.registraduria.gov.co/elecciones/elecciones2014/presidente/2v/99PR2/DPR1599999_L1.htm,7,7,2463,1114,1068,20,1088,21,5,510,46.87,558,51.28
NEMOCON,CUNDINAMARCA,http://www3.registraduria.gov.co/elecciones/elecciones2014/presidente/2v/99PR2/DPR1517599_L1.htm,http://www3.registraduria.gov.co/elecciones/elecciones2014/presidente/2v/99PR2/DPR1599999_L1.htm,23,23,8334,5060,4630,221,4851,201,8,2524,52.03,2106,43.41
NILO,CUNDINAMARCA,http://www3.registraduria.gov.co/elecciones/elecciones2014/presidente/2v/99PR2/DPR1517899_L1.htm,http://www3.registraduria.gov.co/elecciones/elecciones2014/presidente/2v/99PR2/DPR1599999_L1.htm,17,17,6149,3022,2919,62,2981,25,16,1220,40.92,1699,56.99
NIMAIMA,CUNDINAMARCA,http://www3.registraduria.gov.co/elecciones/elecciones2014/presidente/2v/99PR2/DPR1518199_L1.htm,http://www3.registraduria.gov.co/elecciones/elecciones2014/presidente/2v/99PR2/DPR1599999_L1.htm,9,9,3071,1757,1705,26,1731,19,7,411,23.74,1294,74.75
NOCAIMA,CUNDINAMARCA,http://www3.registraduria.gov.co/elecciones/elecciones2014/presidente/2v/99PR2/DPR1518499_L1.htm,http://www3.registraduria.gov.co/elecciones/elecciones2014/presidente/2v/99PR2/DPR1599999_L1.htm,14,14,5135,2841,2695,85,2780,51,10,1060,38.12,1635,58.81
PACHO,CUNDINAMARCA,http://www3.registraduria.gov.co/elecciones/elecciones2014/presidente/2v/99PR2/DPR1519099_L1.htm,http://www3.registraduria.gov.co/elecciones/elecciones2014/presidente/2v/99PR2/DPR1599999_L1.htm,52,52,19875,10379,9788,316,10104,230,45,4045,40.03,5743,56.83
PAIME,CUNDINAMARCA,http://www3.registraduria.gov.co/elecciones/elecciones2014/presidente/2v/99PR2/DPR1519399_L1.htm,http://www3.registraduria.gov.co/elecciones/elecciones2014/presidente/2v/99PR2/DPR1599999_L1.htm,14,14,4433,2047,1996,17,2013,22,12,1030,51.16,966,47.98
PANDI,CUNDINAMARCA,http://www3.registraduria.gov.co/elecciones/elecciones2014/presidente/2v/99PR2/DPR1519699_L1.htm,http://www3.registraduria.gov.co/elecciones/elecciones2014/presidente/2v/99PR2/DPR1599999_L1.htm,11,11,4012,2019,1945,34,1979,32,8,897,45.32,1048,52.95
PARATEBUENO (LA NAGUAYA),CUNDINAMARCA,http://www3.registraduria.gov.co/elecciones/elecciones2014/presidente/2v/99PR2/DPR1519899_L1.htm,http://www3.registraduria.gov.co/elecciones/elecciones2014/presidente/2v/99PR2/DPR1599999_L1.htm,21,21,6905,3785,3644,65,3709,64,12,1156,31.16,2488,67.08
PASCA,CUNDINAMARCA,http://www3.registraduria.gov.co/elecciones/elecciones2014/presidente/2v/99PR2/DPR1519999_L1.htm,http://www3.registraduria.gov.co/elecciones/elecciones2014/presidente/2v/99PR2/DPR1599999_L1.htm,18,18,7051,3586,3396,97,3493,89,4,1818,52.04,1578,45.17
PUERTO SALGAR,CUNDINAMARCA,http://www3.registraduria.gov.co/elecciones/elecciones2014/presidente/2v/99PR2/DPR1520299_L1.htm,http://www3.registraduria.gov.co/elecciones/elecciones2014/presidente/2v/99PR2/DPR1599999_L1.htm,34,34,13044,5749,5279,172,5451,276,22,2163,39.68,3116,57.16
PULI,CUNDINAMARCA,http://www3.registraduria.gov.co/elecciones/elecciones2014/presidente/2v/99PR2/DPR1520599_L1.htm,http://www3.registraduria.gov.co/elecciones/elecciones2014/presidente/2v/99PR2/DPR1599999_L1.htm,9,9,2817,1309,1273,14,1287,17,5,378,29.37,895,69.54
QUEBRADANEGRA,CUNDINAMARCA,http://www3.registraduria.gov.co/elecciones/elecciones2014/presidente/2v/99PR2/DPR1520899_L1.htm,http://www3.registraduria.gov.co/elecciones/elecciones2014/presidente/2v/99PR2/DPR1599999_L1.htm,12,12,3891,2343,2258,41,2299,34,10,457,19.87,1801,78.33
QUETAME,CUNDINAMARCA,http://www3.registraduria.gov.co/elecciones/elecciones2014/presidente/2v/99PR2/DPR1521199_L1.htm,http://www3.registraduria.gov.co/elecciones/elecciones2014/presidente/2v/99PR2/DPR1599999_L1.htm,15,15,5261,3017,2835,94,2929,77,11,679,23.18,2156,73.60
QUIPILE,CUNDINAMARCA,http://www3.registraduria.gov.co/elecciones/elecciones2014/presidente/2v/99PR2/DPR1521499_L1.htm,http://www3.registraduria.gov.co/elecciones/elecciones2014/presidente/2v/99PR2/DPR1599999_L1.htm,19,19,6084,3181,3073,47,3120,45,16,825,26.44,2248,72.05
RICAURTE,CUNDINAMARCA,http://www3.registraduria.gov.co/elecciones/elecciones2014/presidente/2v/99PR2/DPR1521899_L1.htm,http://www3.registraduria.gov.co/elecciones/elecciones2014/presidente/2v/99PR2/DPR1599999_L1.htm,26,26,9961,5297,5077,116,5193,89,15,2791,53.74,2286,44.02
SAN ANTONIO DEL TEQUENDAMA,CUNDINAMARCA,http://www3.registraduria.gov.co/elecciones/elecciones2014/presidente/2v/99PR2/DPR1522099_L1.htm,http://www3.registraduria.gov.co/elecciones/elecciones2014/presidente/2v/99PR2/DPR1599999_L1.htm,22,22,8190,4352,4150,105,4255,88,9,1901,44.67,2249,52.85
SAN BERNARDO,CUNDINAMARCA,http://www3.registraduria.gov.co/elecciones/elecciones2014/presidente/2v/99PR2/DPR1522399_L1.htm,http://www3.registraduria.gov.co/elecciones/elecciones2014/presidente/2v/99PR2/DPR1599999_L1.htm,20,20,7614,3876,3721,69,3790,78,8,1259,33.21,2462,64.96
SAN CAYETANO,CUNDINAMARCA,http://www3.registraduria.gov.co/elecciones/elecciones2014/presidente/2v/99PR2/DPR1522699_L1.htm,http://www3.registraduria.gov.co/elecciones/elecciones2014/presidente/2v/99PR2/DPR1599999_L1.htm,13,13,4348,1885,1815,40,1855,17,13,562,30.29,1253,67.54
SAN FRANCISCO,CUNDINAMARCA,http://www3.registraduria.gov.co/elecciones/elecciones2014/presidente/2v/99PR2/DPR1522999_L1.htm,http://www3.registraduria.gov.co/elecciones/elecciones2014/presidente/2v/99PR2/DPR1599999_L1.htm,21,21,7842,4235,3992,140,4132,92,11,1175,28.43,2817,68.17
SAN JUAN DE RIOSECO,CUNDINAMARCA,http://www3.registraduria.gov.co/elecciones/elecciones2014/presidente/2v/99PR2/DPR1523299_L1.htm,http://www3.registraduria.gov.co/elecciones/elecciones2014/presidente/2v/99PR2/DPR1599999_L1.htm,24,24,8876,4487,4328,72,4400,65,22,1738,39.50,2590,58.86
SASAIMA,CUNDINAMARCA,http://www3.registraduria.gov.co/elecciones/elecciones2014/presidente/2v/99PR2/DPR1523599_L1.htm,http://www3.registraduria.gov.co/elecciones/elecciones2014/presidente/2v/99PR2/DPR1599999_L1.htm,23,23,8417,4387,4187,101,4288,92,7,1270,29.61,2917,68.02
SESQUILE,CUNDINAMARCA,http://www3.registraduria.gov.co/elecciones/elecciones2014/presidente/2v/99PR2/DPR1523899_L1.htm,http://www3.registraduria.gov.co/elecciones/elecciones2014/presidente/2v/99PR2/DPR1599999_L1.htm,19,19,7304,4351,3854,233,4087,253,11,1903,46.56,1951,47.73
SIBATE,CUNDINAMARCA,http://www3.registraduria.gov.co/elecciones/elecciones2014/presidente/2v/99PR2/DPR1523999_L1.htm,http://www3.registraduria.gov.co/elecciones/elecciones2014/presidente/2v/99PR2/DPR1599999_L1.htm,60,60,22986,12850,11525,598,12123,701,26,4536,37.41,6989,57.65
SILVANIA,CUNDINAMARCA,http://www3.registraduria.gov.co/elecciones/elecciones2014/presidente/2v/99PR2/DPR1524199_L1.htm,http://www3.registraduria.gov.co/elecciones/elecciones2014/presidente/2v/99PR2/DPR1599999_L1.htm,42,42,16048,8554,8215,168,8383,152,19,2750,32.80,5465,65.19
SIMIJACA,CUNDINAMARCA,http://www3.registraduria.gov.co/elecciones/elecciones2014/presidente/2v/99PR2/DPR1524499_L1.htm,http://www3.registraduria.gov.co/elecciones/elecciones2014/presidente/2v/99PR2/DPR1599999_L1.htm,22,22,8220,4595,4235,181,4416,164,15,1293,29.27,2942,66.62
SOACHA,CUNDINAMARCA,http://www3.registraduria.gov.co/elecciones/elecciones2014/presidente/2v/99PR2/DPR1524799_L1.htm,http://www3.registraduria.gov.co/elecciones/elecciones2014/presidente/2v/99PR2/DPR1599999_L1.htm,486,486,190969,104179,95024,4754,99778,4288,113,49914,50.02,45110,45.21
SOPO,CUNDINAMARCA,http://www3.registraduria.gov.co/elecciones/elecciones2014/presidente/2v/99PR2/DPR1525099_L1.htm,http://www3.registraduria.gov.co/elecciones/elecciones2014/presidente/2v/99PR2/DPR1599999_L1.htm,39,39,14970,9653,8778,499,9277,370,6,5570,60.04,3208,34.58
SUBACHOQUE,CUNDINAMARCA,http://www3.registraduria.gov.co/elecciones/elecciones2014/presidente/2v/99PR2/DPR1525699_L1.htm,http://www3.registraduria.gov.co/elecciones/elecciones2014/presidente/2v/99PR2/DPR1599999_L1.htm,28,28,10630,6888,6301,311,6612,270,6,1722,26.04,4579,69.25
SUESCA,CUNDINAMARCA,http://www3.registraduria.gov.co/elecciones/elecciones2014/presidente/2v/99PR2/DPR1525999_L1.htm,http://www3.registraduria.gov.co/elecciones/elecciones2014/presidente/2v/99PR2/DPR1599999_L1.htm,25,25,9435,5595,4942,312,5254,335,6,3049,58.03,1893,36.02
SUPATA,CUNDINAMARCA,http://www3.registraduria.gov.co/elecciones/elecciones2014/presidente/2v/99PR2/DPR1526299_L1.htm,http://www3.registraduria.gov.co/elecciones/elecciones2014/presidente/2v/99PR2/DPR1599999_L1.htm,11,11,4176,2236,2132,47,2179,46,11,504,23.12,1628,74.71
SUSA,CUNDINAMARCA,http://www3.registraduria.gov.co/elecciones/elecciones2014/presidente/2v/99PR2/DPR1526599_L1.htm,http://www3.registraduria.gov.co/elecciones/elecciones2014/presidente/2v/99PR2/DPR1599999_L1.htm,13,13,5052,2770,2539,95,2634,118,18,810,30.75,1729,65.64
SUTATAUSA,CUNDINAMARCA,http://www3.registraduria.gov.co/elecciones/elecciones2014/presidente/2v/99PR2/DPR1526899_L1.htm,http://www3.registraduria.gov.co/elecciones/elecciones2014/presidente/2v/99PR2/DPR1599999_L1.htm,11,11,3679,2229,2065,101,2166,58,5,453,20.91,1612,74.42
TABIO,CUNDINAMARCA,http://www3.registraduria.gov.co/elecciones/elecciones2014/presidente/2v/99PR2/DPR1527199_L1.htm,http://www3.registraduria.gov.co/elecciones/elecciones2014/presidente/2v/99PR2/DPR1599999_L1.htm,36,36,13814,8408,7529,512,8041,353,14,3344,41.58,4185,52.04
TAUSA,CUNDINAMARCA,http://www3.registraduria.gov.co/elecciones/elecciones2014/presidente/2v/99PR2/DPR1527499_L1.htm,http://www3.registraduria.gov.co/elecciones/elecciones2014/presidente/2v/99PR2/DPR1599999_L1.htm,15,15,5527,3451,3256,104,3360,82,9,502,14.94,2754,81.96
TENA,CUNDINAMARCA,http://www3.registraduria.gov.co/elecciones/elecciones2014/presidente/2v/99PR2/DPR1527799_L1.htm,http://www3.registraduria.gov.co/elecciones/elecciones2014/presidente/2v/99PR2/DPR1599999_L1.htm,16,16,6050,3244,3135,55,3190,42,12,1443,45.23,1692,53.04
TENJO,CUNDINAMARCA,http://www3.registraduria.gov.co/elecciones/elecciones2014/presidente/2v/99PR2/DPR1528099_L1.htm,http://www3.registraduria.gov.co/elecciones/elecciones2014/presidente/2v/99PR2/DPR1599999_L1.htm,34,34,13067,7979,7221,447,7668,306,5,3195,41.66,4026,52.50
TIBACUY,CUNDINAMARCA,http://www3.registraduria.gov.co/elecciones/elecciones2014/presidente/2v/99PR2/DPR1528399_L1.htm,http://www3.registraduria.gov.co/elecciones/elecciones2014/presidente/2v/99PR2/DPR1599999_L1.htm,11,11,3638,1868,1802,29,1831,18,19,765,41.78,1037,56.63
TIBIRITA,CUNDINAMARCA,http://www3.registraduria.gov.co/elecciones/elecciones2014/presidente/2v/99PR2/DPR1528699_L1.htm,http://www3.registraduria.gov.co/elecciones/elecciones2014/presidente/2v/99PR2/DPR1599999_L1.htm,8,8,3033,1419,1349,41,1390,23,6,534,38.41,815,58.63
TOCAIMA,CUNDINAMARCA,http://www3.registraduria.gov.co/elecciones/elecciones2014/presidente/2v/99PR2/DPR1528999_L1.htm,http://www3.registraduria.gov.co/elecciones/elecciones2014/presidente/2v/99PR2/DPR1599999_L1.htm,33,33,12777,6541,6309,131,6440,79,22,3132,48.63,3177,49.33
TOCANCIPA,CUNDINAMARCA,http://www3.registraduria.gov.co/elecciones/elecciones2014/presidente/2v/99PR2/DPR1529299_L1.htm,http://www3.registraduria.gov.co/elecciones/elecciones2014/presidente/2v/99PR2/DPR1599999_L1.htm,57,57,21852,13728,12088,787,12875,839,14,6930,53.82,5158,40.06
TOPAIPI,CUNDINAMARCA,http://www3.registraduria.gov.co/elecciones/elecciones2014/presidente/2v/99PR2/DPR1529599_L1.htm,http://www3.registraduria.gov.co/elecciones/elecciones2014/presidente/2v/99PR2/DPR1599999_L1.htm,12,12,4084,2036,1961,21,1982,38,16,1002,50.55,959,48.38
UBALA,CUNDINAMARCA,http://www3.registraduria.gov.co/elecciones/elecciones2014/presidente/2v/99PR2/DPR1529899_L1.htm,http://www3.registraduria.gov.co/elecciones/elecciones2014/presidente/2v/99PR2/DPR1599999_L1.htm,25,25,8421,3570,3399,80,3479,71,20,1295,37.22,2104,60.47
UBAQUE,CUNDINAMARCA,http://www3.registraduria.gov.co/elecciones/elecciones2014/presidente/2v/99PR2/DPR1530199_L1.htm,http://www3.registraduria.gov.co/elecciones/elecciones2014/presidente/2v/99PR2/DPR1599999_L1.htm,14,14,5478,3047,2879,86,2965,73,9,820,27.65,2059,69.44
UBATE,CUNDINAMARCA,http://www3.registraduria.gov.co/elecciones/elecciones2014/presidente/2v/99PR2/DPR1530499_L1.htm,http://www3.registraduria.gov.co/elecciones/elecciones2014/presidente/2v/99PR2/DPR1599999_L1.htm,76,76,28883,15295,13498,969,14467,790,38,4271,29.52,9227,63.77
UNE,CUNDINAMARCA,http://www3.registraduria.gov.co/elecciones/elecciones2014/presidente/2v/99PR2/DPR1530799_L1.htm,http://www3.registraduria.gov.co/elecciones/elecciones2014/presidente/2v/99PR2/DPR1599999_L1.htm,17,17,6049,3722,3552,92,3644,69,9,1008,27.66,2544,69.81
UTICA,CUNDINAMARCA,http://www3.registraduria.gov.co/elecciones/elecciones2014/presidente/2v/99PR2/DPR1531699_L1.htm,http://www3.registraduria.gov.co/elecciones/elecciones2014/presidente/2v/99PR2/DPR1599999_L1.htm,12,12,4587,2596,2518,34,2552,25,19,665,26.05,1853,72.60
VENECIA,CUNDINAMARCA,http://www3.registraduria.gov.co/elecciones/elecciones2014/presidente/2v/99PR2/DPR1531899_L1.htm,http://www3.registraduria.gov.co/elecciones/elecciones2014/presidente/2v/99PR2/DPR1599999_L1.htm,10,10,3438,1641,1573,36,1609,28,4,657,40.83,916,56.92
VERGARA,CUNDINAMARCA,http://www3.registraduria.gov.co/elecciones/elecciones2014/presidente/2v/99PR2/DPR1531999_L1.htm,http://www3.registraduria.gov.co/elecciones/elecciones2014/presidente/2v/99PR2/DPR1599999_L1.htm,20,20,7002,3323,3205,49,3254,40,29,720,22.12,2485,76.36
VIANI,CUNDINAMARCA,http://www3.registraduria.gov.co/elecciones/elecciones2014/presidente/2v/99PR2/DPR1532299_L1.htm,http://www3.registraduria.gov.co/elecciones/elecciones2014/presidente/2v/99PR2/DPR1599999_L1.htm,10,10,3810,1961,1886,42,1928,29,4,710,36.82,1176,60.99
VILLAGOMEZ,CUNDINAMARCA,http://www3.registraduria.gov.co/elecciones/elecciones2014/presidente/2v/99PR2/DPR1532399_L1.htm,http://www3.registraduria.gov.co/elecciones/elecciones2014/presidente/2v/99PR2/DPR1599999_L1.htm,6,6,1895,1011,974,19,993,14,4,511,51.46,463,46.62
VILLAPINZON,CUNDINAMARCA,http://www3.registraduria.gov.co/elecciones/elecciones2014/presidente/2v/99PR2/DPR1532599_L1.htm,http://www3.registraduria.gov.co/elecciones/elecciones2014/presidente/2v/99PR2/DPR1599999_L1.htm,32,32,12299,7725,7214,302,7516,187,22,1346,17.90,5868,78.07
VILLETA,CUNDINAMARCA,http://www3.registraduria.gov.co/elecciones/elecciones2014/presidente/2v/99PR2/DPR1532899_L1.htm,http://www3.registraduria.gov.co/elecciones/elecciones2014/presidente/2v/99PR2/DPR1599999_L1.htm,57,57,21096,11858,11253,325,11578,245,35,2962,25.58,8291,71.60
VIOTA,CUNDINAMARCA,http://www3.registraduria.gov.co/elecciones/elecciones2014/presidente/2v/99PR2/DPR1533199_L1.htm,http://www3.registraduria.gov.co/elecciones/elecciones2014/presidente/2v/99PR2/DPR1599999_L1.htm,27,27,9915,5220,5062,79,5141,58,21,2071,40.28,2991,58.17
YACOPI,CUNDINAMARCA,http://www3.registraduria.gov.co/elecciones/elecciones2014/presidente/2v/99PR2/DPR1533499_L1.htm,http://www3.registraduria.gov.co/elecciones/elecciones2014/presidente/2v/99PR2/DPR1599999_L1.htm,36,36,11480,4910,4759,49,4808,84,18,1986,41.30,2773,57.67
ZIPACON,CUNDINAMARCA,http://www3.registraduria.gov.co/elecciones/elecciones2014/presidente/2v/99PR2/DPR1533799_L1.htm,http://www3.registraduria.gov.co/elecciones/elecciones2014/presidente/2v/99PR2/DPR1599999_L1.htm,11,11,3821,2388,2219,89,2308,71,9,945,40.94,1274,55.19
ZIPAQUIRA,CUNDINAMARCA,http://www3.registraduria.gov.co/elecciones/elecciones2014/presidente/2v/99PR2/DPR1534099_L1.htm,http://www3.registraduria.gov.co/elecciones/elecciones2014/presidente/2v/99PR2/DPR1599999_L1.htm,185,185,76180,43701,38936,2546,41482,2166,53,24331,58.65,14605,35.20
BARRANCO MINAS,GUAINIA,http://www3.registraduria.gov.co/elecciones/elecciones2014/presidente/2v/99PR2/DPR5007099_L1.htm,http://www3.registraduria.gov.co/elecciones/elecciones2014/presidente/2v/99PR2/DPR5099999_L1.htm,7,7,1899,410,388,17,405,5,0,246,60.74,142,35.06
CACAHUAL,GUAINIA,http://www3.registraduria.gov.co/elecciones/elecciones2014/presidente/2v/99PR2/DPR5007399_L1.htm,http://www3.registraduria.gov.co/elecciones/elecciones2014/presidente/2v/99PR2/DPR5099999_L1.htm,1,1,305,52,50,2,52,0,0,40,76.92,10,19.23
INIRIDA,GUAINIA,http://www3.registraduria.gov.co/elecciones/elecciones2014/presidente/2v/99PR2/DPR5000199_L1.htm,http://www3.registraduria.gov.co/elecciones/elecciones2014/presidente/2v/99PR2/DPR5099999_L1.htm,46,46,16907,6802,6541,166,6707,73,22,3581,53.39,2960,44.13
LA GUADALUPE,GUAINIA,http://www3.registraduria.gov.co/elecciones/elecciones2014/presidente/2v/99PR2/DPR5007899_L1.htm,http://www3.registraduria.gov.co/elecciones/elecciones2014/presidente/2v/99PR2/DPR5099999_L1.htm,1,1,133,43,43,0,43,0,0,11,25.58,32,74.41
MAPIRIPANA,GUAINIA,http://www3.registraduria.gov.co/elecciones/elecciones2014/presidente/2v/99PR2/DPR5005099_L1.htm,http://www3.registraduria.gov.co/elecciones/elecciones2014/presidente/2v/99PR2/DPR5099999_L1.htm,3,3,583,85,78,7,85,0,0,57,67.05,21,24.70
MORICHAL (MORICHAL NUEVO),GUAINIA,http://www3.registraduria.gov.co/elecciones/elecciones2014/presidente/2v/99PR2/DPR5008399_L1.htm,http://www3.registraduria.gov.co/elecciones/elecciones2014/presidente/2v/99PR2/DPR5099999_L1.htm,1,1,159,23,23,0,23,0,0,22,95.65,1,4.34
PANA PANA (CAMPO ALEGRE),GUAINIA,http://www3.registraduria.gov.co/elecciones/elecciones2014/presidente/2v/99PR2/DPR5008799_L1.htm,http://www3.registraduria.gov.co/elecciones/elecciones2014/presidente/2v/99PR2/DPR5099999_L1.htm,3,3,288,161,160,0,160,0,1,128,80.00,32,20.00
PUERTO COLOMBIA,GUAINIA,http://www3.registraduria.gov.co/elecciones/elecciones2014/presidente/2v/99PR2/DPR5009099_L1.htm,http://www3.registraduria.gov.co/elecciones/elecciones2014/presidente/2v/99PR2/DPR5099999_L1.htm,3,3,981,151,142,3,145,2,4,97,66.89,45,31.03
SAN FELIPE,GUAINIA,http://www3.registraduria.gov.co/elecciones/elecciones2014/presidente/2v/99PR2/DPR5009299_L1.htm,http://www3.registraduria.gov.co/elecciones/elecciones2014/presidente/2v/99PR2/DPR5099999_L1.htm,2,2,678,195,185,6,191,2,2,92,48.16,93,48.69
CALAMAR,GUAVIARE,http://www3.registraduria.gov.co/elecciones/elecciones2014/presidente/2v/99PR2/DPR5400399_L1.htm,http://www3.registraduria.gov.co/elecciones/elecciones2014/presidente/2v/99PR2/DPR5499999_L1.htm,13,13,4913,1890,1823,40,1863,18,9,1453,77.99,370,19.86
EL RETORNO,GUAVIARE,http://www3.registraduria.gov.co/elecciones/elecciones2014/presidente/2v/99PR2/DPR5400799_L1.htm,http://www3.registraduria.gov.co/elecciones/elecciones2014/presidente/2v/99PR2/DPR5499999_L1.htm,26,26,9125,4379,4159,128,4287,68,24,2287,53.34,1872,43.66
MIRAFLORES,GUAVIARE,http://www3.registraduria.gov.co/elecciones/elecciones2014/presidente/2v/99PR2/DPR5401299_L1.htm,http://www3.registraduria.gov.co/elecciones/elecciones2014/presidente/2v/99PR2/DPR5499999_L1.htm,14,14,4165,1128,1082,26,1108,14,6,918,82.85,164,14.80
SAN JOSE DEL GUAVIARE,GUAVIARE,http://www3.registraduria.gov.co/elecciones/elecciones2014/presidente/2v/99PR2/DPR5400199_L1.htm,http://www3.registraduria.gov.co/elecciones/elecciones2014/presidente/2v/99PR2/DPR5499999_L1.htm,93,93,34915,14869,13823,608,14431,380,58,5397,37.39,8426,58.38
ACEVEDO,HUILA,http://www3.registraduria.gov.co/elecciones/elecciones2014/presidente/2v/99PR2/DPR1900499_L1.htm,http://www3.registraduria.gov.co/elecciones/elecciones2014/presidente/2v/99PR2/DPR1999999_L1.htm,46,46,17268,10666,10403,123,10526,93,47,670,6.36,9733,92.46
AGRADO,HUILA,http://www3.registraduria.gov.co/elecciones/elecciones2014/presidente/2v/99PR2/DPR1900799_L1.htm,http://www3.registraduria.gov.co/elecciones/elecciones2014/presidente/2v/99PR2/DPR1999999_L1.htm,16,16,6159,3449,3273,105,3378,54,17,909,26.90,2364,69.98
AIPE,HUILA,http://www3.registraduria.gov.co/elecciones/elecciones2014/presidente/2v/99PR2/DPR1901099_L1.htm,http://www3.registraduria.gov.co/elecciones/elecciones2014/presidente/2v/99PR2/DPR1999999_L1.htm,40,40,14586,6331,6011,180,6191,120,20,2094,33.82,3917,63.26
ALGECIRAS,HUILA,http://www3.registraduria.gov.co/elecciones/elecciones2014/presidente/2v/99PR2/DPR1901399_L1.htm,http://www3.registraduria.gov.co/elecciones/elecciones2014/presidente/2v/99PR2/DPR1999999_L1.htm,36,36,13530,5925,5646,130,5776,116,33,2602,45.04,3044,52.70
ALTAMIRA,HUILA,http://www3.registraduria.gov.co/elecciones/elecciones2014/presidente/2v/99PR2/DPR1901699_L1.htm,http://www3.registraduria.gov.co/elecciones/elecciones2014/presidente/2v/99PR2/DPR1999999_L1.htm,8,8,2840,1423,1345,43,1388,30,5,434,31.26,911,65.63
BARAYA,HUILA,http://www3.registraduria.gov.co/elecciones/elecciones2014/presidente/2v/99PR2/DPR1901999_L1.htm,http://www3.registraduria.gov.co/elecciones/elecciones2014/presidente/2v/99PR2/DPR1999999_L1.htm,18,18,5895,2496,2353,60,2413,72,11,875,36.26,1478,61.25
CAMPOALEGRE,HUILA,http://www3.registraduria.gov.co/elecciones/elecciones2014/presidente/2v/99PR2/DPR1902299_L1.htm,http://www3.registraduria.gov.co/elecciones/elecciones2014/presidente/2v/99PR2/DPR1999999_L1.htm,61,61,23580,11066,10308,338,10646,385,35,3445,32.35,6863,64.46
COLOMBIA,HUILA,http://www3.registraduria.gov.co/elecciones/elecciones2014/presidente/2v/99PR2/DPR1902899_L1.htm,http://www3.registraduria.gov.co/elecciones/elecciones2014/presidente/2v/99PR2/DPR1999999_L1.htm,19,19,6505,2981,2880,54,2934,30,17,659,22.46,2221,75.69
ELIAS,HUILA,http://www3.registraduria.gov.co/elecciones/elecciones2014/presidente/2v/99PR2/DPR1903199_L1.htm,http://www3.registraduria.gov.co/elecciones/elecciones2014/presidente/2v/99PR2/DPR1999999_L1.htm,8,8,2833,1669,1611,27,1638,22,9,226,13.79,1385,84.55
GARZON,HUILA,http://www3.registraduria.gov.co/elecciones/elecciones2014/presidente/2v/99PR2/DPR1903499_L1.htm,http://www3.registraduria.gov.co/elecciones/elecciones2014/presidente/2v/99PR2/DPR1999999_L1.htm,121,121,49043,24645,22884,1059,23943,631,71,4369,18.24,18515,77.32
GIGANTE,HUILA,http://www3.registraduria.gov.co/elecciones/elecciones2014/presidente/2v/99PR2/DPR1903799_L1.htm,http://www3.registraduria.gov.co/elecciones/elecciones2014/presidente/2v/99PR2/DPR1999999_L1.htm,48,48,17892,8981,8422,304,8726,217,38,1683,19.28,6739,77.22
GUADALUPE,HUILA,http://www3.registraduria.gov.co/elecciones/elecciones2014/presidente/2v/99PR2/DPR1904099_L1.htm,http://www3.registraduria.gov.co/elecciones/elecciones2014/presidente/2v/99PR2/DPR1999999_L1.htm,30,30,11555,6487,6229,130,6359,111,17,784,12.32,5445,85.62
HOBO,HUILA,http://www3.registraduria.gov.co/elecciones/elecciones2014/presidente/2v/99PR2/DPR1904399_L1.htm,http://www3.registraduria.gov.co/elecciones/elecciones2014/presidente/2v/99PR2/DPR1999999_L1.htm,14,14,5315,2696,2560,73,2633,56,7,612,23.24,1948,73.98
IQUIRA,HUILA,http://www3.registraduria.gov.co/elecciones/elecciones2014/presidente/2v/99PR2/DPR1904699_L1.htm,http://www3.registraduria.gov.co/elecciones/elecciones2014/presidente/2v/99PR2/DPR1999999_L1.htm,18,18,6523,3621,3414,120,3534,72,15,888,25.12,2526,71.47
ISNOS,HUILA,http://www3.registraduria.gov.co/elecciones/elecciones2014/presidente/2v/99PR2/DPR1904499_L1.htm,http://www3.registraduria.gov.co/elecciones/elecciones2014/presidente/2v/99PR2/DPR1999999_L1.htm,46,46,17129,10244,9685,272,9957,214,73,1831,18.38,7854,78.87
LA ARGENTINA (PLATA VIEJA),HUILA,http://www3.registraduria.gov.co/elecciones/elecciones2014/presidente/2v/99PR2/DPR1904799_L1.htm,http://www3.registraduria.gov.co/elecciones/elecciones2014/presidente/2v/99PR2/DPR1999999_L1.htm,25,25,9408,4857,4570,155,4725,111,21,792,16.76,3778,79.95
LA PLATA,HUILA,http://www3.registraduria.gov.co/elecciones/elecciones2014/presidente/2v/99PR2/DPR1904999_L1.htm,http://www3.registraduria.gov.co/elecciones/elecciones2014/presidente/2v/99PR2/DPR1999999_L1.htm,92,92,38306,18988,17966,521,18487,408,93,3714,20.08,14252,77.09
NATAGA,HUILA,http://www3.registraduria.gov.co/elecciones/elecciones2014/presidente/2v/99PR2/DPR1905099_L1.htm,http://www3.registraduria.gov.co/elecciones/elecciones2014/presidente/2v/99PR2/DPR1999999_L1.htm,12,12,4158,2347,2256,54,2310,30,7,376,16.27,1880,81.38
NEIVA,HUILA,http://www3.registraduria.gov.co/elecciones/elecciones2014/presidente/2v/99PR2/DPR1900199_L1.htm,http://www3.registraduria.gov.co/elecciones/elecciones2014/presidente/2v/99PR2/DPR1999999_L1.htm,597,597,238445,114673,106468,4763,111231,3254,188,44212,39.74,62256,55.97
OPORAPA,HUILA,http://www3.registraduria.gov.co/elecciones/elecciones2014/presidente/2v/99PR2/DPR1905199_L1.htm,http://www3.registraduria.gov.co/elecciones/elecciones2014/presidente/2v/99PR2/DPR1999999_L1.htm,19,19,6993,4629,4510,72,4582,42,5,276,6.02,4234,92.40
PAICOL,HUILA,http://www3.registraduria.gov.co/elecciones/elecciones2014/presidente/2v/99PR2/DPR1905299_L1.htm,http://www3.registraduria.gov.co/elecciones/elecciones2014/presidente/2v/99PR2/DPR1999999_L1.htm,12,12,4513,2690,2564,71,2635,48,7,229,8.69,2335,88.61
PALERMO,HUILA,http://www3.registraduria.gov.co/elecciones/elecciones2014/presidente/2v/99PR2/DPR1905599_L1.htm,http://www3.registraduria.gov.co/elecciones/elecciones2014/presidente/2v/99PR2/DPR1999999_L1.htm,56,56,19861,9610,9131,269,9400,188,22,2544,27.06,6587,70.07
PALESTINA,HUILA,http://www3.registraduria.gov.co/elecciones/elecciones2014/presidente/2v/99PR2/DPR1905699_L1.htm,http://www3.registraduria.gov.co/elecciones/elecciones2014/presidente/2v/99PR2/DPR1999999_L1.htm,21,21,8081,4478,4263,123,4386,73,19,461,10.51,3802,86.68
PITAL,HUILA,http://www3.registraduria.gov.co/elecciones/elecciones2014/presidente/2v/99PR2/DPR1905899_L1.htm,http://www3.registraduria.gov.co/elecciones/elecciones2014/presidente/2v/99PR2/DPR1999999_L1.htm,23,23,8872,4838,4655,105,4760,66,12,663,13.92,3992,83.86
PITALITO,HUILA,http://www3.registraduria.gov.co/elecciones/elecciones2014/presidente/2v/99PR2/DPR1906199_L1.htm,http://www3.registraduria.gov.co/elecciones/elecciones2014/presidente/2v/99PR2/DPR1999999_L1.htm,200,200,81905,41804,39730,1122,40852,834,118,7031,17.21,32699,80.04
RIVERA,HUILA,http://www3.registraduria.gov.co/elecciones/elecciones2014/presidente/2v/99PR2/DPR1906499_L1.htm,http://www3.registraduria.gov.co/elecciones/elecciones2014/presidente/2v/99PR2/DPR1999999_L1.htm,41,41,15448,7256,6761,265,7026,215,15,2608,37.11,4153,59.10
SALADOBLANCO,HUILA,http://www3.registraduria.gov.co/elecciones/elecciones2014/presidente/2v/99PR2/DPR1906799_L1.htm,http://www3.registraduria.gov.co/elecciones/elecciones2014/presidente/2v/99PR2/DPR1999999_L1.htm,23,23,8039,5163,5056,54,5110,27,26,371,7.26,4685,91.68
SAN AGUSTIN,HUILA,http://www3.registraduria.gov.co/elecciones/elecciones2014/presidente/2v/99PR2/DPR1907099_L1.htm,http://www3.registraduria.gov.co/elecciones/elecciones2014/presidente/2v/99PR2/DPR1999999_L1.htm,60,60,22119,12406,11726,352,12078,255,73,2439,20.19,9287,76.89
SANTA MARIA,HUILA,http://www3.registraduria.gov.co/elecciones/elecciones2014/presidente/2v/99PR2/DPR1907499_L1.htm,http://www3.registraduria.gov.co/elecciones/elecciones2014/presidente/2v/99PR2/DPR1999999_L1.htm,20,20,7516,4500,4353,72,4425,68,7,398,8.99,3955,89.37
SUAZA,HUILA,http://www3.registraduria.gov.co/elecciones/elecciones2014/presidente/2v/99PR2/DPR1907699_L1.htm,http://www3.registraduria.gov.co/elecciones/elecciones2014/presidente/2v/99PR2/DPR1999999_L1.htm,29,29,10859,6243,6008,113,6121,84,38,803,13.11,5205,85.03
TARQUI,HUILA,http://www3.registraduria.gov.co/elecciones/elecciones2014/presidente/2v/99PR2/DPR1907999_L1.htm,http://www3.registraduria.gov.co/elecciones/elecciones2014/presidente/2v/99PR2/DPR1999999_L1.htm,31,31,10994,6186,5892,169,6061,105,20,975,16.08,4917,81.12
TELLO,HUILA,http://www3.registraduria.gov.co/elecciones/elecciones2014/presidente/2v/99PR2/DPR1908299_L1.htm,http://www3.registraduria.gov.co/elecciones/elecciones2014/presidente/2v/99PR2/DPR1999999_L1.htm,29,29,10483,4635,4378,127,4505,110,20,1340,29.74,3038,67.43
TERUEL,HUILA,http://www3.registraduria.gov.co/elecciones/elecciones2014/presidente/2v/99PR2/DPR1908599_L1.htm,http://www3.registraduria.gov.co/elecciones/elecciones2014/presidente/2v/99PR2/DPR1999999_L1.htm,17,17,6228,3376,3277,54,3331,35,10,475,14.25,2802,84.11
TESALIA (CARNICERIAS),HUILA,http://www3.registraduria.gov.co/elecciones/elecciones2014/presidente/2v/99PR2/DPR1902599_L1.htm,http://www3.registraduria.gov.co/elecciones/elecciones2014/presidente/2v/99PR2/DPR1999999_L1.htm,20,20,7520,4210,3978,110,4088,109,13,504,12.32,3474,84.98
TIMANA,HUILA,http://www3.registraduria.gov.co/elecciones/elecciones2014/presidente/2v/99PR2/DPR1908899_L1.htm,http://www3.registraduria.gov.co/elecciones/elecciones2014/presidente/2v/99PR2/DPR1999999_L1.htm,39,39,14480,8355,8059,155,8214,114,27,1344,16.36,6715,81.75
VILLAVIEJA,HUILA,http://www3.registraduria.gov.co/elecciones/elecciones2014/presidente/2v/99PR2/DPR1909199_L1.htm,http://www3.registraduria.gov.co/elecciones/elecciones2014/presidente/2v/99PR2/DPR1999999_L1.htm,18,18,6423,3272,3107,75,3182,74,16,1471,46.22,1636,51.41
YAGUARA,HUILA,http://www3.registraduria.gov.co/elecciones/elecciones2014/presidente/2v/99PR2/DPR1909499_L1.htm,http://www3.registraduria.gov.co/elecciones/elecciones2014/presidente/2v/99PR2/DPR1999999_L1.htm,18,18,6551,3397,3062,157,3219,170,8,880,27.33,2182,67.78
ALBANIA,LA GUAJIRA,http://www3.registraduria.gov.co/elecciones/elecciones2014/presidente/2v/99PR2/DPR4800299_L1.htm,http://www3.registraduria.gov.co/elecciones/elecciones2014/presidente/2v/99PR2/DPR4899999_L1.htm,41,41,15674,6470,6259,110,6369,85,16,4624,72.60,1635,25.67
BARRANCAS,LA GUAJIRA,http://www3.registraduria.gov.co/elecciones/elecciones2014/presidente/2v/99PR2/DPR4800499_L1.htm,http://www3.registraduria.gov.co/elecciones/elecciones2014/presidente/2v/99PR2/DPR4899999_L1.htm,64,64,23135,9858,9652,112,9764,78,16,7122,72.94,2530,25.91
DIBULLA,LA GUAJIRA,http://www3.registraduria.gov.co/elecciones/elecciones2014/presidente/2v/99PR2/DPR4800599_L1.htm,http://www3.registraduria.gov.co/elecciones/elecciones2014/presidente/2v/99PR2/DPR4899999_L1.htm,55,55,20295,7946,7805,66,7871,60,15,6260,79.53,1545,19.62
DISTRACCION,LA GUAJIRA,http://www3.registraduria.gov.co/elecciones/elecciones2014/presidente/2v/99PR2/DPR4800899_L1.htm,http://www3.registraduria.gov.co/elecciones/elecciones2014/presidente/2v/99PR2/DPR4899999_L1.htm,24,24,7739,3874,3799,43,3842,28,4,2889,75.19,910,23.68
EL MOLINO,LA GUAJIRA,http://www3.registraduria.gov.co/elecciones/elecciones2014/presidente/2v/99PR2/DPR4800699_L1.htm,http://www3.registraduria.gov.co/elecciones/elecciones2014/presidente/2v/99PR2/DPR4899999_L1.htm,17,17,6331,3420,3387,20,3407,11,2,2624,77.01,763,22.39
FONSECA,LA GUAJIRA,http://www3.registraduria.gov.co/elecciones/elecciones2014/presidente/2v/99PR2/DPR4800799_L1.htm,http://www3.registraduria.gov.co/elecciones/elecciones2014/presidente/2v/99PR2/DPR4899999_L1.htm,64,64,23839,12856,12599,166,12765,82,9,10391,81.40,2208,17.29
HATONUEVO,LA GUAJIRA,http://www3.registraduria.gov.co/elecciones/elecciones2014/presidente/2v/99PR2/DPR4800999_L1.htm,http://www3.registraduria.gov.co/elecciones/elecciones2014/presidente/2v/99PR2/DPR4899999_L1.htm,34,34,12872,6036,5888,84,5972,56,8,4809,80.52,1079,18.06
LA JAGUA DEL PILAR,LA GUAJIRA,http://www3.registraduria.gov.co/elecciones/elecciones2014/presidente/2v/99PR2/DPR4801299_L1.htm,http://www3.registraduria.gov.co/elecciones/elecciones2014/presidente/2v/99PR2/DPR4899999_L1.htm,11,11,3655,1843,1819,12,1831,10,2,1387,75.75,432,23.59
MAICAO,LA GUAJIRA,http://www3.registraduria.gov.co/elecciones/elecciones2014/presidente/2v/99PR2/DPR4801099_L1.htm,http://www3.registraduria.gov.co/elecciones/elecciones2014/presidente/2v/99PR2/DPR4899999_L1.htm,273,273,109613,30186,29197,569,29766,341,79,20151,67.69,9046,30.39
MANAURE,LA GUAJIRA,http://www3.registraduria.gov.co/elecciones/elecciones2014/presidente/2v/99PR2/DPR4801199_L1.htm,http://www3.registraduria.gov.co/elecciones/elecciones2014/presidente/2v/99PR2/DPR4899999_L1.htm,134,134,50470,8076,7809,96,7905,114,57,6069,76.77,1740,22.01
RIOHACHA,LA GUAJIRA,http://www3.registraduria.gov.co/elecciones/elecciones2014/presidente/2v/99PR2/DPR4800199_L1.htm,http://www3.registraduria.gov.co/elecciones/elecciones2014/presidente/2v/99PR2/DPR4899999_L1.htm,261,261,100254,42834,41306,977,42283,437,114,31330,74.09,9976,23.59
SAN JUAN DEL CESAR,LA GUAJIRA,http://www3.registraduria.gov.co/elecciones/elecciones2014/presidente/2v/99PR2/DPR4801399_L1.htm,http://www3.registraduria.gov.co/elecciones/elecciones2014/presidente/2v/99PR2/DPR4899999_L1.htm,87,87,29492,14101,13644,275,13919,164,18,6357,45.67,7287,52.35
URIBIA,LA GUAJIRA,http://www3.registraduria.gov.co/elecciones/elecciones2014/presidente/2v/99PR2/DPR4801699_L1.htm,http://www3.registraduria.gov.co/elecciones/elecciones2014/presidente/2v/99PR2/DPR4899999_L1.htm,235,235,87532,9862,9503,118,9621,173,68,6734,69.99,2769,28.78
URUMITA,LA GUAJIRA,http://www3.registraduria.gov.co/elecciones/elecciones2014/presidente/2v/99PR2/DPR4801899_L1.htm,http://www3.registraduria.gov.co/elecciones/elecciones2014/presidente/2v/99PR2/DPR4899999_L1.htm,20,20,7696,4339,4261,42,4303,29,7,3143,73.04,1118,25.98
VILLANUEVA,LA GUAJIRA,http://www3.registraduria.gov.co/elecciones/elecciones2014/presidente/2v/99PR2/DPR4802099_L1.htm,http://www3.registraduria.gov.co/elecciones/elecciones2014/presidente/2v/99PR2/DPR4899999_L1.htm,44,44,16974,9162,8953,116,9069,80,13,6143,67.73,2810,30.98
ALGARROBO,MAGDALENA,http://www3.registraduria.gov.co/elecciones/elecciones2014/presidente/2v/99PR2/DPR2100899_L1.htm,http://www3.registraduria.gov.co/elecciones/elecciones2014/presidente/2v/99PR2/DPR2199999_L1.htm,25,25,8874,4927,4782,48,4830,78,19,3877,80.26,905,18.73
ARACATACA,MAGDALENA,http://www3.registraduria.gov.co/elecciones/elecciones2014/presidente/2v/99PR2/DPR2101099_L1.htm,http://www3.registraduria.gov.co/elecciones/elecciones2014/presidente/2v/99PR2/DPR2199999_L1.htm,72,72,26809,11134,10741,154,10895,204,35,7832,71.88,2909,26.70
ARIGUANI (EL DIFICIL),MAGDALENA,http://www3.registraduria.gov.co/elecciones/elecciones2014/presidente/2v/99PR2/DPR2101299_L1.htm,http://www3.registraduria.gov.co/elecciones/elecciones2014/presidente/2v/99PR2/DPR2199999_L1.htm,55,55,20834,9790,9541,125,9666,94,30,6201,64.15,3340,34.55
CERRO DE SAN ANTONIO,MAGDALENA,http://www3.registraduria.gov.co/elecciones/elecciones2014/presidente/2v/99PR2/DPR2101399_L1.htm,http://www3.registraduria.gov.co/elecciones/elecciones2014/presidente/2v/99PR2/DPR2199999_L1.htm,23,23,7978,3799,3770,9,3779,15,5,3328,88.06,442,11.69
CHIVOLO,MAGDALENA,http://www3.registraduria.gov.co/elecciones/elecciones2014/presidente/2v/99PR2/DPR2101599_L1.htm,http://www3.registraduria.gov.co/elecciones/elecciones2014/presidente/2v/99PR2/DPR2199999_L1.htm,34,34,12327,6073,6008,27,6035,34,4,3981,65.96,2027,33.58
CIENAGA,MAGDALENA,http://www3.registraduria.gov.co/elecciones/elecciones2014/presidente/2v/99PR2/DPR2101699_L1.htm,http://www3.registraduria.gov.co/elecciones/elecciones2014/presidente/2v/99PR2/DPR2199999_L1.htm,191,191,76163,30929,29841,599,30440,430,59,19700,64.71,10141,33.31
CONCORDIA,MAGDALENA,http://www3.registraduria.gov.co/elecciones/elecciones2014/presidente/2v/99PR2/DPR2102099_L1.htm,http://www3.registraduria.gov.co/elecciones/elecciones2014/presidente/2v/99PR2/DPR2199999_L1.htm,29,29,10252,4851,4806,13,4819,26,6,3977,82.52,829,17.20
EL BANCO,MAGDALENA,http://www3.registraduria.gov.co/elecciones/elecciones2014/presidente/2v/99PR2/DPR2102599_L1.htm,http://www3.registraduria.gov.co/elecciones/elecciones2014/presidente/2v/99PR2/DPR2199999_L1.htm,114,114,44049,19814,19336,230,19566,211,37,11109,56.77,8227,42.04
EL PIÑON,MAGDALENA,http://www3.registraduria.gov.co/elecciones/elecciones2014/presidente/2v/99PR2/DPR2102899_L1.htm,http://www3.registraduria.gov.co/elecciones/elecciones2014/presidente/2v/99PR2/DPR2199999_L1.htm,36,36,12509,7066,6975,34,7009,42,15,5438,77.58,1537,21.92
EL RETEN,MAGDALENA,http://www3.registraduria.gov.co/elecciones/elecciones2014/presidente/2v/99PR2/DPR2103099_L1.htm,http://www3.registraduria.gov.co/elecciones/elecciones2014/presidente/2v/99PR2/DPR2199999_L1.htm,31,31,11818,6153,6053,40,6093,49,11,5289,86.80,764,12.53
FUNDACION,MAGDALENA,http://www3.registraduria.gov.co/elecciones/elecciones2014/presidente/2v/99PR2/DPR2103199_L1.htm,http://www3.registraduria.gov.co/elecciones/elecciones2014/presidente/2v/99PR2/DPR2199999_L1.htm,115,115,47620,20194,19578,390,19968,192,34,10449,52.32,9129,45.71
GUAMAL,MAGDALENA,http://www3.registraduria.gov.co/elecciones/elecciones2014/presidente/2v/99PR2/DPR2104099_L1.htm,http://www3.registraduria.gov.co/elecciones/elecciones2014/presidente/2v/99PR2/DPR2199999_L1.htm,67,67,21463,7825,7665,75,7740,63,22,5183,66.96,2482,32.06
NUEVA GRANADA,MAGDALENA,http://www3.registraduria.gov.co/elecciones/elecciones2014/presidente/2v/99PR2/DPR2104299_L1.htm,http://www3.registraduria.gov.co/elecciones/elecciones2014/presidente/2v/99PR2/DPR2199999_L1.htm,38,38,13707,7268,7121,38,7159,62,47,3692,51.57,3429,47.89
PEDRAZA,MAGDALENA,http://www3.registraduria.gov.co/elecciones/elecciones2014/presidente/2v/99PR2/DPR2104699_L1.htm,http://www3.registraduria.gov.co/elecciones/elecciones2014/presidente/2v/99PR2/DPR2199999_L1.htm,25,25,8690,3968,3895,22,3917,47,4,2705,69.05,1190,30.38
PIJIÑO DEL CARMEN,MAGDALENA,http://www3.registraduria.gov.co/elecciones/elecciones2014/presidente/2v/99PR2/DPR2104899_L1.htm,http://www3.registraduria.gov.co/elecciones/elecciones2014/presidente/2v/99PR2/DPR2199999_L1.htm,24,24,7592,3792,3721,27,3748,38,6,1973,52.64,1748,46.63
PIVIJAY,MAGDALENA,http://www3.registraduria.gov.co/elecciones/elecciones2014/presidente/2v/99PR2/DPR2104999_L1.htm,http://www3.registraduria.gov.co/elecciones/elecciones2014/presidente/2v/99PR2/DPR2199999_L1.htm,74,74,27784,13511,13302,98,13400,82,29,11599,86.55,1703,12.70
PLATO,MAGDALENA,http://www3.registraduria.gov.co/elecciones/elecciones2014/presidente/2v/99PR2/DPR2105299_L1.htm,http://www3.registraduria.gov.co/elecciones/elecciones2014/presidente/2v/99PR2/DPR2199999_L1.htm,95,95,36776,17426,17053,152,17205,168,53,11821,68.70,5232,30.40
PUEBLOVIEJO,MAGDALENA,http://www3.registraduria.gov.co/elecciones/elecciones2014/presidente/2v/99PR2/DPR2105599_L1.htm,http://www3.registraduria.gov.co/elecciones/elecciones2014/presidente/2v/99PR2/DPR2199999_L1.htm,55,55,20024,8985,8801,76,8877,83,25,6659,75.01,2142,24.12
REMOLINO,MAGDALENA,http://www3.registraduria.gov.co/elecciones/elecciones2014/presidente/2v/99PR2/DPR2105899_L1.htm,http://www3.registraduria.gov.co/elecciones/elecciones2014/presidente/2v/99PR2/DPR2199999_L1.htm,22,22,7011,3726,3663,10,3673,36,17,3216,87.55,447,12.16
SABANAS DE SAN ANGEL,MAGDALENA,http://www3.registraduria.gov.co/elecciones/elecciones2014/presidente/2v/99PR2/DPR2106099_L1.htm,http://www3.registraduria.gov.co/elecciones/elecciones2014/presidente/2v/99PR2/DPR2199999_L1.htm,28,28,9933,5338,5252,18,5270,55,13,3301,62.63,1951,37.02
SALAMINA,MAGDALENA,http://www3.registraduria.gov.co/elecciones/elecciones2014/presidente/2v/99PR2/DPR2106799_L1.htm,http://www3.registraduria.gov.co/elecciones/elecciones2014/presidente/2v/99PR2/DPR2199999_L1.htm,20,20,7246,3790,3728,31,3759,23,8,2731,72.65,997,26.52
SAN SEBASTIAN DE BUENAVISTA,MAGDALENA,http://www3.registraduria.gov.co/elecciones/elecciones2014/presidente/2v/99PR2/DPR2107099_L1.htm,http://www3.registraduria.gov.co/elecciones/elecciones2014/presidente/2v/99PR2/DPR2199999_L1.htm,47,47,14956,7357,7281,30,7311,37,9,5415,74.06,1866,25.52
SAN ZENON,MAGDALENA,http://www3.registraduria.gov.co/elecciones/elecciones2014/presidente/2v/99PR2/DPR2107399_L1.htm,http://www3.registraduria.gov.co/elecciones/elecciones2014/presidente/2v/99PR2/DPR2199999_L1.htm,26,26,7616,4238,4195,15,4210,25,3,3474,82.51,721,17.12
SANTA ANA,MAGDALENA,http://www3.registraduria.gov.co/elecciones/elecciones2014/presidente/2v/99PR2/DPR2107699_L1.htm,http://www3.registraduria.gov.co/elecciones/elecciones2014/presidente/2v/99PR2/DPR2199999_L1.htm,38,38,14471,7573,7463,40,7503,60,10,3476,46.32,3987,53.13
SANTA BARBARA DE PINTO,MAGDALENA,http://www3.registraduria.gov.co/elecciones/elecciones2014/presidente/2v/99PR2/DPR2107899_L1.htm,http://www3.registraduria.gov.co/elecciones/elecciones2014/presidente/2v/99PR2/DPR2199999_L1.htm,23,23,7668,4359,4319,21,4340,16,3,3374,77.74,945,21.77
SANTA MARTA,MAGDALENA,http://www3.registraduria.gov.co/elecciones/elecciones2014/presidente/2v/99PR2/DPR2100199_L1.htm,http://www3.registraduria.gov.co/elecciones/elecciones2014/presidente/2v/99PR2/DPR2199999_L1.htm,735,735,297561,131512,125993,3582,129575,1823,114,85523,66.00,40470,31.23
SITIONUEVO,MAGDALENA,http://www3.registraduria.gov.co/elecciones/elecciones2014/presidente/2v/99PR2/DPR2107999_L1.htm,http://www3.registraduria.gov.co/elecciones/elecciones2014/presidente/2v/99PR2/DPR2199999_L1.htm,46,46,17715,6950,6817,43,6860,78,12,5672,82.68,1145,16.69
TENERIFE,MAGDALENA,http://www3.registraduria.gov.co/elecciones/elecciones2014/presidente/2v/99PR2/DPR2108599_L1.htm,http://www3.registraduria.gov.co/elecciones/elecciones2014/presidente/2v/99PR2/DPR2199999_L1.htm,29,29,9616,4761,4713,21,4734,18,9,3928,82.97,785,16.58
ZAPAYAN,MAGDALENA,http://www3.registraduria.gov.co/elecciones/elecciones2014/presidente/2v/99PR2/DPR2109099_L1.htm,http://www3.registraduria.gov.co/elecciones/elecciones2014/presidente/2v/99PR2/DPR2199999_L1.htm,22,22,7518,3540,3486,10,3496,31,13,1797,51.40,1689,48.31
ZONA BANANERA (SEVILLA),MAGDALENA,http://www3.registraduria.gov.co/elecciones/elecciones2014/presidente/2v/99PR2/DPR2109599_L1.htm,http://www3.registraduria.gov.co/elecciones/elecciones2014/presidente/2v/99PR2/DPR2199999_L1.htm,109,109,40922,17214,16775,220,16995,182,37,12708,74.77,4067,23.93
ACACIAS,META,http://www3.registraduria.gov.co/elecciones/elecciones2014/presidente/2v/99PR2/DPR5200599_L1.htm,http://www3.registraduria.gov.co/elecciones/elecciones2014/presidente/2v/99PR2/DPR5299999_L1.htm,132,132,51288,32849,30074,1159,31233,1554,62,7662,24.53,22412,71.75
BARRANCA DE UPIA,META,http://www3.registraduria.gov.co/elecciones/elecciones2014/presidente/2v/99PR2/DPR5200699_L1.htm,http://www3.registraduria.gov.co/elecciones/elecciones2014/presidente/2v/99PR2/DPR5299999_L1.htm,13,13,4104,2127,2012,57,2069,54,4,730,35.28,1282,61.96
CABUYARO,META,http://www3.registraduria.gov.co/elecciones/elecciones2014/presidente/2v/99PR2/DPR5200899_L1.htm,http://www3.registraduria.gov.co/elecciones/elecciones2014/presidente/2v/99PR2/DPR5299999_L1.htm,13,13,4409,2381,2296,43,2339,31,11,873,37.32,1423,60.83
CASTILLA LA NUEVA,META,http://www3.registraduria.gov.co/elecciones/elecciones2014/presidente/2v/99PR2/DPR5201099_L1.htm,http://www3.registraduria.gov.co/elecciones/elecciones2014/presidente/2v/99PR2/DPR5299999_L1.htm,27,27,9488,6750,6095,281,6376,363,11,1908,29.92,4187,65.66
CUBARRAL,META,http://www3.registraduria.gov.co/elecciones/elecciones2014/presidente/2v/99PR2/DPR5201599_L1.htm,http://www3.registraduria.gov.co/elecciones/elecciones2014/presidente/2v/99PR2/DPR5299999_L1.htm,13,13,4854,2759,2641,61,2702,47,10,550,20.35,2091,77.38
CUMARAL,META,http://www3.registraduria.gov.co/elecciones/elecciones2014/presidente/2v/99PR2/DPR5202099_L1.htm,http://www3.registraduria.gov.co/elecciones/elecciones2014/presidente/2v/99PR2/DPR5299999_L1.htm,42,42,14598,8602,8041,330,8371,217,14,2437,29.11,5604,66.94
EL CALVARIO,META,http://www3.registraduria.gov.co/elecciones/elecciones2014/presidente/2v/99PR2/DPR5202599_L1.htm,http://www3.registraduria.gov.co/elecciones/elecciones2014/presidente/2v/99PR2/DPR5299999_L1.htm,7,7,1638,901,872,19,891,8,2,200,22.44,672,75.42
EL CASTILLO,META,http://www3.registraduria.gov.co/elecciones/elecciones2014/presidente/2v/99PR2/DPR5202799_L1.htm,http://www3.registraduria.gov.co/elecciones/elecciones2014/presidente/2v/99PR2/DPR5299999_L1.htm,15,15,5199,2407,2311,34,2345,49,13,1308,55.77,1003,42.77
EL DORADO,META,http://www3.registraduria.gov.co/elecciones/elecciones2014/presidente/2v/99PR2/DPR5202899_L1.htm,http://www3.registraduria.gov.co/elecciones/elecciones2014/presidente/2v/99PR2/DPR5299999_L1.htm,10,10,2754,1722,1654,41,1695,21,6,427,25.19,1227,72.38
FUENTE DE ORO,META,http://www3.registraduria.gov.co/elecciones/elecciones2014/presidente/2v/99PR2/DPR5203099_L1.htm,http://www3.registraduria.gov.co/elecciones/elecciones2014/presidente/2v/99PR2/DPR5299999_L1.htm,26,26,9093,5154,4919,115,5034,111,9,2059,40.90,2860,56.81
GRANADA,META,http://www3.registraduria.gov.co/elecciones/elecciones2014/presidente/2v/99PR2/DPR5203599_L1.htm,http://www3.registraduria.gov.co/elecciones/elecciones2014/presidente/2v/99PR2/DPR5299999_L1.htm,110,110,44337,23942,22485,804,23289,563,90,8659,37.18,13826,59.36
GUAMAL,META,http://www3.registraduria.gov.co/elecciones/elecciones2014/presidente/2v/99PR2/DPR5204099_L1.htm,http://www3.registraduria.gov.co/elecciones/elecciones2014/presidente/2v/99PR2/DPR5299999_L1.htm,26,26,9768,6370,5992,217,6209,149,12,1329,21.40,4663,75.10
LA MACARENA,META,http://www3.registraduria.gov.co/elecciones/elecciones2014/presidente/2v/99PR2/DPR5204199_L1.htm,http://www3.registraduria.gov.co/elecciones/elecciones2014/presidente/2v/99PR2/DPR5299999_L1.htm,21,21,7314,3096,2943,103,3046,25,25,1799,59.06,1144,37.55
LEJANIAS,META,http://www3.registraduria.gov.co/elecciones/elecciones2014/presidente/2v/99PR2/DPR5204299_L1.htm,http://www3.registraduria.gov.co/elecciones/elecciones2014/presidente/2v/99PR2/DPR5299999_L1.htm,22,22,7592,3949,3754,96,3850,77,22,1358,35.27,2396,62.23
MAPIRIPAN,META,http://www3.registraduria.gov.co/elecciones/elecciones2014/presidente/2v/99PR2/DPR5204699_L1.htm,http://www3.registraduria.gov.co/elecciones/elecciones2014/presidente/2v/99PR2/DPR5299999_L1.htm,20,20,5681,1750,1676,26,1702,34,14,819,48.11,857,50.35
MESETAS,META,http://www3.registraduria.gov.co/elecciones/elecciones2014/presidente/2v/99PR2/DPR5204499_L1.htm,http://www3.registraduria.gov.co/elecciones/elecciones2014/presidente/2v/99PR2/DPR5299999_L1.htm,21,21,7259,3236,3078,86,3164,54,18,1593,50.34,1485,46.93
PUERTO CONCORDIA,META,http://www3.registraduria.gov.co/elecciones/elecciones2014/presidente/2v/99PR2/DPR5204799_L1.htm,http://www3.registraduria.gov.co/elecciones/elecciones2014/presidente/2v/99PR2/DPR5299999_L1.htm,15,15,5584,2318,2202,53,2255,45,18,984,43.63,1218,54.01
PUERTO GAITAN,META,http://www3.registraduria.gov.co/elecciones/elecciones2014/presidente/2v/99PR2/DPR5204399_L1.htm,http://www3.registraduria.gov.co/elecciones/elecciones2014/presidente/2v/99PR2/DPR5299999_L1.htm,52,52,18493,7914,7329,257,7586,264,64,3017,39.77,4312,56.84
PUERTO LLERAS,META,http://www3.registraduria.gov.co/elecciones/elecciones2014/presidente/2v/99PR2/DPR5204899_L1.htm,http://www3.registraduria.gov.co/elecciones/elecciones2014/presidente/2v/99PR2/DPR5299999_L1.htm,18,18,6119,3015,2892,67,2959,48,8,1027,34.70,1865,63.02
PUERTO LOPEZ,META,http://www3.registraduria.gov.co/elecciones/elecciones2014/presidente/2v/99PR2/DPR5204599_L1.htm,http://www3.registraduria.gov.co/elecciones/elecciones2014/presidente/2v/99PR2/DPR5299999_L1.htm,60,60,21536,11120,10607,278,10885,201,34,2935,26.96,7672,70.48
PUERTO RICO,META,http://www3.registraduria.gov.co/elecciones/elecciones2014/presidente/2v/99PR2/DPR5204999_L1.htm,http://www3.registraduria.gov.co/elecciones/elecciones2014/presidente/2v/99PR2/DPR5299999_L1.htm,22,22,7930,3693,3523,65,3588,88,17,1456,40.57,2067,57.60
RESTREPO,META,http://www3.registraduria.gov.co/elecciones/elecciones2014/presidente/2v/99PR2/DPR5205099_L1.htm,http://www3.registraduria.gov.co/elecciones/elecciones2014/presidente/2v/99PR2/DPR5299999_L1.htm,37,37,14568,7455,7071,226,7297,154,4,1960,26.86,5111,70.04
SAN CARLOS DE GUAROA,META,http://www3.registraduria.gov.co/elecciones/elecciones2014/presidente/2v/99PR2/DPR5205599_L1.htm,http://www3.registraduria.gov.co/elecciones/elecciones2014/presidente/2v/99PR2/DPR5299999_L1.htm,20,20,7191,4266,4050,107,4157,97,12,1280,30.79,2770,66.63
SAN JUAN DE ARAMA,META,http://www3.registraduria.gov.co/elecciones/elecciones2014/presidente/2v/99PR2/DPR5205899_L1.htm,http://www3.registraduria.gov.co/elecciones/elecciones2014/presidente/2v/99PR2/DPR5299999_L1.htm,17,17,5654,2843,2701,73,2774,52,17,1135,40.91,1566,56.45
SAN JUANITO,META,http://www3.registraduria.gov.co/elecciones/elecciones2014/presidente/2v/99PR2/DPR5205999_L1.htm,http://www3.registraduria.gov.co/elecciones/elecciones2014/presidente/2v/99PR2/DPR5299999_L1.htm,6,6,1234,743,711,30,741,1,1,97,13.09,614,82.86
SAN MARTIN DE LOS LLANOS,META,http://www3.registraduria.gov.co/elecciones/elecciones2014/presidente/2v/99PR2/DPR5206099_L1.htm,http://www3.registraduria.gov.co/elecciones/elecciones2014/presidente/2v/99PR2/DPR5299999_L1.htm,47,47,17012,9639,8979,342,9321,295,23,2820,30.25,6159,66.07
URIBE,META,http://www3.registraduria.gov.co/elecciones/elecciones2014/presidente/2v/99PR2/DPR5207499_L1.htm,http://www3.registraduria.gov.co/elecciones/elecciones2014/presidente/2v/99PR2/DPR5299999_L1.htm,13,13,4222,1810,1749,23,1772,31,7,1573,88.76,176,9.93
VILLAVICENCIO,META,http://www3.registraduria.gov.co/elecciones/elecciones2014/presidente/2v/99PR2/DPR5200199_L1.htm,http://www3.registraduria.gov.co/elecciones/elecciones2014/presidente/2v/99PR2/DPR5299999_L1.htm,784,784,307107,165482,153819,6604,160423,4797,262,51641,32.19,102178,63.69
VISTA HERMOSA,META,http://www3.registraduria.gov.co/elecciones/elecciones2014/presidente/2v/99PR2/DPR5208099_L1.htm,http://www3.registraduria.gov.co/elecciones/elecciones2014/presidente/2v/99PR2/DPR5299999_L1.htm,31,31,10932,5665,5333,197,5530,102,33,2112,38.19,3221,58.24
ALBAN (SAN JOSE),NARIÑO,http://www3.registraduria.gov.co/elecciones/elecciones2014/presidente/2v/99PR2/DPR2300499_L1.htm,http://www3.registraduria.gov.co/elecciones/elecciones2014/presidente/2v/99PR2/DPR2399999_L1.htm,17,17,6160,3990,3823,81,3904,55,31,735,18.82,3088,79.09
ALDANA,NARIÑO,http://www3.registraduria.gov.co/elecciones/elecciones2014/presidente/2v/99PR2/DPR2300799_L1.htm,http://www3.registraduria.gov.co/elecciones/elecciones2014/presidente/2v/99PR2/DPR2399999_L1.htm,16,16,5477,3174,3003,86,3089,68,17,1719,55.64,1284,41.56
ANCUYA,NARIÑO,http://www3.registraduria.gov.co/elecciones/elecciones2014/presidente/2v/99PR2/DPR2301099_L1.htm,http://www3.registraduria.gov.co/elecciones/elecciones2014/presidente/2v/99PR2/DPR2399999_L1.htm,24,24,7258,3653,3537,74,3611,32,10,2644,73.22,893,24.72
ARBOLEDA (BERRUECOS),NARIÑO,http://www3.registraduria.gov.co/elecciones/elecciones2014/presidente/2v/99PR2/DPR2301399_L1.htm,http://www3.registraduria.gov.co/elecciones/elecciones2014/presidente/2v/99PR2/DPR2399999_L1.htm,16,16,5398,2914,2763,86,2849,48,17,698,24.49,2065,72.48
BARBACOAS,NARIÑO,http://www3.registraduria.gov.co/elecciones/elecciones2014/presidente/2v/99PR2/DPR2301699_L1.htm,http://www3.registraduria.gov.co/elecciones/elecciones2014/presidente/2v/99PR2/DPR2399999_L1.htm,66,66,20336,6194,5931,131,6062,94,38,4582,75.58,1349,22.25
BELEN,NARIÑO,http://www3.registraduria.gov.co/elecciones/elecciones2014/presidente/2v/99PR2/DPR2301799_L1.htm,http://www3.registraduria.gov.co/elecciones/elecciones2014/presidente/2v/99PR2/DPR2399999_L1.htm,14,14,5071,2788,2643,108,2751,27,10,1573,57.17,1070,38.89
BUESACO,NARIÑO,http://www3.registraduria.gov.co/elecciones/elecciones2014/presidente/2v/99PR2/DPR2301999_L1.htm,http://www3.registraduria.gov.co/elecciones/elecciones2014/presidente/2v/99PR2/DPR2399999_L1.htm,45,45,16112,8727,8380,175,8555,125,47,3631,42.44,4749,55.51
CHACHAGUI,NARIÑO,http://www3.registraduria.gov.co/elecciones/elecciones2014/presidente/2v/99PR2/DPR2303899_L1.htm,http://www3.registraduria.gov.co/elecciones/elecciones2014/presidente/2v/99PR2/DPR2399999_L1.htm,27,27,9102,5419,5216,92,5308,77,34,3533,66.55,1683,31.70
COLON (GENOVA),NARIÑO,http://www3.registraduria.gov.co/elecciones/elecciones2014/presidente/2v/99PR2/DPR2302299_L1.htm,http://www3.registraduria.gov.co/elecciones/elecciones2014/presidente/2v/99PR2/DPR2399999_L1.htm,21,21,6404,3426,3089,161,3250,139,37,1395,42.92,1694,52.12
CONSACA,NARIÑO,http://www3.registraduria.gov.co/elecciones/elecciones2014/presidente/2v/99PR2/DPR2302599_L1.htm,http://www3.registraduria.gov.co/elecciones/elecciones2014/presidente/2v/99PR2/DPR2399999_L1.htm,31,31,8352,4822,4630,102,4732,69,21,2949,62.32,1681,35.52
CONTADERO,NARIÑO,http://www3.registraduria.gov.co/elecciones/elecciones2014/presidente/2v/99PR2/DPR2302899_L1.htm,http://www3.registraduria.gov.co/elecciones/elecciones2014/presidente/2v/99PR2/DPR2399999_L1.htm,16,16,5384,2796,2664,86,2750,33,13,868,31.56,1796,65.30
CORDOBA,NARIÑO,http://www3.registraduria.gov.co/elecciones/elecciones2014/presidente/2v/99PR2/DPR2303199_L1.htm,http://www3.registraduria.gov.co/elecciones/elecciones2014/presidente/2v/99PR2/DPR2399999_L1.htm,28,28,9592,4716,4380,193,4573,100,43,2746,60.04,1634,35.73
CUASPUD (CARLOSAMA),NARIÑO,http://www3.registraduria.gov.co/elecciones/elecciones2014/presidente/2v/99PR2/DPR2303499_L1.htm,http://www3.registraduria.gov.co/elecciones/elecciones2014/presidente/2v/99PR2/DPR2399999_L1.htm,19,19,6789,3682,3453,123,3576,71,35,2109,58.97,1344,37.58
CUMBAL,NARIÑO,http://www3.registraduria.gov.co/elecciones/elecciones2014/presidente/2v/99PR2/DPR2303799_L1.htm,http://www3.registraduria.gov.co/elecciones/elecciones2014/presidente/2v/99PR2/DPR2399999_L1.htm,60,60,22230,12372,11921,253,12174,150,48,9195,75.52,2726,22.39
CUMBITARA,NARIÑO,http://www3.registraduria.gov.co/elecciones/elecciones2014/presidente/2v/99PR2/DPR2303999_L1.htm,http://www3.registraduria.gov.co/elecciones/elecciones2014/presidente/2v/99PR2/DPR2399999_L1.htm,19,19,5839,2754,2677,45,2722,24,8,2494,91.62,183,6.72
EL CHARCO,NARIÑO,http://www3.registraduria.gov.co/elecciones/elecciones2014/presidente/2v/99PR2/DPR2304199_L1.htm,http://www3.registraduria.gov.co/elecciones/elecciones2014/presidente/2v/99PR2/DPR2399999_L1.htm,43,43,14377,6719,6596,30,6626,73,20,6257,94.43,339,5.11
EL PEÑOL,NARIÑO,http://www3.registraduria.gov.co/elecciones/elecciones2014/presidente/2v/99PR2/DPR2304499_L1.htm,http://www3.registraduria.gov.co/elecciones/elecciones2014/presidente/2v/99PR2/DPR2399999_L1.htm,17,17,5141,3328,3269,23,3292,24,12,2153,65.40,1116,33.90
EL ROSARIO,NARIÑO,http://www3.registraduria.gov.co/elecciones/elecciones2014/presidente/2v/99PR2/DPR2304099_L1.htm,http://www3.registraduria.gov.co/elecciones/elecciones2014/presidente/2v/99PR2/DPR2399999_L1.htm,21,21,6489,3080,3026,17,3043,29,8,2799,91.98,227,7.45
EL TABLON,NARIÑO,http://www3.registraduria.gov.co/elecciones/elecciones2014/presidente/2v/99PR2/DPR2304399_L1.htm,http://www3.registraduria.gov.co/elecciones/elecciones2014/presidente/2v/99PR2/DPR2399999_L1.htm,29,29,10315,6008,5821,125,5946,45,17,2652,44.60,3169,53.29
EL TAMBO,NARIÑO,http://www3.registraduria.gov.co/elecciones/elecciones2014/presidente/2v/99PR2/DPR2304699_L1.htm,http://www3.registraduria.gov.co/elecciones/elecciones2014/presidente/2v/99PR2/DPR2399999_L1.htm,31,31,10875,6487,6204,118,6322,123,42,4224,66.81,1980,31.31
FRANCISCO PIZARRO (SALAHONDA),NARIÑO,http://www3.registraduria.gov.co/elecciones/elecciones2014/presidente/2v/99PR2/DPR2304799_L1.htm,http://www3.registraduria.gov.co/elecciones/elecciones2014/presidente/2v/99PR2/DPR2399999_L1.htm,21,21,5950,2374,2304,35,2339,25,10,2057,87.94,247,10.56
FUNES,NARIÑO,http://www3.registraduria.gov.co/elecciones/elecciones2014/presidente/2v/99PR2/DPR2304999_L1.htm,http://www3.registraduria.gov.co/elecciones/elecciones2014/presidente/2v/99PR2/DPR2399999_L1.htm,17,17,5282,3183,3100,37,3137,30,16,2214,70.57,886,28.24
GUACHUCAL,NARIÑO,http://www3.registraduria.gov.co/elecciones/elecciones2014/presidente/2v/99PR2/DPR2305299_L1.htm,http://www3.registraduria.gov.co/elecciones/elecciones2014/presidente/2v/99PR2/DPR2399999_L1.htm,38,38,13509,8114,7725,181,7906,140,68,5655,71.52,2070,26.18
GUAITARILLA,NARIÑO,http://www3.registraduria.gov.co/elecciones/elecciones2014/presidente/2v/99PR2/DPR2305599_L1.htm,http://www3.registraduria.gov.co/elecciones/elecciones2014/presidente/2v/99PR2/DPR2399999_L1.htm,32,32,10442,5131,4922,100,5022,82,27,3456,68.81,1466,29.19
GUALMATAN,NARIÑO,http://www3.registraduria.gov.co/elecciones/elecciones2014/presidente/2v/99PR2/DPR2305899_L1.htm,http://www3.registraduria.gov.co/elecciones/elecciones2014/presidente/2v/99PR2/DPR2399999_L1.htm,13,13,4840,2674,2427,174,2601,66,7,801,30.79,1626,62.51
ILES,NARIÑO,http://www3.registraduria.gov.co/elecciones/elecciones2014/presidente/2v/99PR2/DPR2306199_L1.htm,http://www3.registraduria.gov.co/elecciones/elecciones2014/presidente/2v/99PR2/DPR2399999_L1.htm,20,20,6646,3123,2974,63,3037,54,32,1478,48.66,1496,49.25
IMUES,NARIÑO,http://www3.registraduria.gov.co/elecciones/elecciones2014/presidente/2v/99PR2/DPR2306499_L1.htm,http://www3.registraduria.gov.co/elecciones/elecciones2014/presidente/2v/99PR2/DPR2399999_L1.htm,20,20,6155,3388,3242,70,3312,61,15,1952,58.93,1290,38.94
IPIALES,NARIÑO,http://www3.registraduria.gov.co/elecciones/elecciones2014/presidente/2v/99PR2/DPR2306799_L1.htm,http://www3.registraduria.gov.co/elecciones/elecciones2014/presidente/2v/99PR2/DPR2399999_L1.htm,212,212,86661,37495,34707,1445,36152,1151,192,19759,54.65,14948,41.34
LA CRUZ,NARIÑO,http://www3.registraduria.gov.co/elecciones/elecciones2014/presidente/2v/99PR2/DPR2307399_L1.htm,http://www3.registraduria.gov.co/elecciones/elecciones2014/presidente/2v/99PR2/DPR2399999_L1.htm,41,41,12866,7720,7372,205,7577,109,34,3353,44.25,4019,53.04
LA FLORIDA,NARIÑO,http://www3.registraduria.gov.co/elecciones/elecciones2014/presidente/2v/99PR2/DPR2307699_L1.htm,http://www3.registraduria.gov.co/elecciones/elecciones2014/presidente/2v/99PR2/DPR2399999_L1.htm,26,26,8851,4863,4702,79,4781,58,24,3221,67.37,1481,30.97
LA LLANADA,NARIÑO,http://www3.registraduria.gov.co/elecciones/elecciones2014/presidente/2v/99PR2/DPR2307799_L1.htm,http://www3.registraduria.gov.co/elecciones/elecciones2014/presidente/2v/99PR2/DPR2399999_L1.htm,10,10,3114,1916,1831,51,1882,25,9,1390,73.85,441,23.43
LA TOLA,NARIÑO,http://www3.registraduria.gov.co/elecciones/elecciones2014/presidente/2v/99PR2/DPR2307899_L1.htm,http://www3.registraduria.gov.co/elecciones/elecciones2014/presidente/2v/99PR2/DPR2399999_L1.htm,15,15,4781,2131,2082,11,2093,28,10,1914,91.44,168,8.02
LA UNION,NARIÑO,http://www3.registraduria.gov.co/elecciones/elecciones2014/presidente/2v/99PR2/DPR2307999_L1.htm,http://www3.registraduria.gov.co/elecciones/elecciones2014/presidente/2v/99PR2/DPR2399999_L1.htm,64,64,20526,10671,10035,377,10412,198,61,3381,32.47,6654,63.90
LEIVA,NARIÑO,http://www3.registraduria.gov.co/elecciones/elecciones2014/presidente/2v/99PR2/DPR2308099_L1.htm,http://www3.registraduria.gov.co/elecciones/elecciones2014/presidente/2v/99PR2/DPR2399999_L1.htm,24,24,6978,3358,3301,37,3338,9,11,2994,89.69,307,9.19
LINARES,NARIÑO,http://www3.registraduria.gov.co/elecciones/elecciones2014/presidente/2v/99PR2/DPR2308299_L1.htm,http://www3.registraduria.gov.co/elecciones/elecciones2014/presidente/2v/99PR2/DPR2399999_L1.htm,25,25,8335,5134,5057,40,5097,26,11,4433,86.97,624,12.24
LOS ANDES (SOTOMAYOR),NARIÑO,http://www3.registraduria.gov.co/elecciones/elecciones2014/presidente/2v/99PR2/DPR2308599_L1.htm,http://www3.registraduria.gov.co/elecciones/elecciones2014/presidente/2v/99PR2/DPR2399999_L1.htm,21,21,6755,4024,3884,86,3970,32,22,3320,83.62,564,14.20
MAGUI (PAYAN),NARIÑO,http://www3.registraduria.gov.co/elecciones/elecciones2014/presidente/2v/99PR2/DPR2308899_L1.htm,http://www3.registraduria.gov.co/elecciones/elecciones2014/presidente/2v/99PR2/DPR2399999_L1.htm,24,24,6033,2449,2389,24,2413,30,6,2175,90.13,214,8.86
MALLAMA (PIEDRANCHA),NARIÑO,http://www3.registraduria.gov.co/elecciones/elecciones2014/presidente/2v/99PR2/DPR2309199_L1.htm,http://www3.registraduria.gov.co/elecciones/elecciones2014/presidente/2v/99PR2/DPR2399999_L1.htm,20,20,5734,2837,2739,53,2792,34,11,2369,84.84,370,13.25
MOSQUERA,NARIÑO,http://www3.registraduria.gov.co/elecciones/elecciones2014/presidente/2v/99PR2/DPR2309499_L1.htm,http://www3.registraduria.gov.co/elecciones/elecciones2014/presidente/2v/99PR2/DPR2399999_L1.htm,21,21,5550,2448,2306,97,2403,28,17,2065,85.93,241,10.02
NARIÑO,NARIÑO,http://www3.registraduria.gov.co/elecciones/elecciones2014/presidente/2v/99PR2/DPR2309699_L1.htm,http://www3.registraduria.gov.co/elecciones/elecciones2014/presidente/2v/99PR2/DPR2399999_L1.htm,11,11,4024,2635,2548,42,2590,36,9,1914,73.89,634,24.47
OLAYA HERRERA,NARIÑO,http://www3.registraduria.gov.co/elecciones/elecciones2014/presidente/2v/99PR2/DPR2309599_L1.htm,http://www3.registraduria.gov.co/elecciones/elecciones2014/presidente/2v/99PR2/DPR2399999_L1.htm,37,37,12534,5632,5522,48,5570,49,13,5152,92.49,370,6.64
OSPINA,NARIÑO,http://www3.registraduria.gov.co/elecciones/elecciones2014/presidente/2v/99PR2/DPR2309799_L1.htm,http://www3.registraduria.gov.co/elecciones/elecciones2014/presidente/2v/99PR2/DPR2399999_L1.htm,17,17,5472,2957,2822,85,2907,28,22,1647,56.65,1175,40.41
PASTO,NARIÑO,http://www3.registraduria.gov.co/elecciones/elecciones2014/presidente/2v/99PR2/DPR2300199_L1.htm,http://www3.registraduria.gov.co/elecciones/elecciones2014/presidente/2v/99PR2/DPR2399999_L1.htm,688,688,266450,149679,141979,4532,146511,2905,263,102800,70.16,39179,26.74
POLICARPA,NARIÑO,http://www3.registraduria.gov.co/elecciones/elecciones2014/presidente/2v/99PR2/DPR2309899_L1.htm,http://www3.registraduria.gov.co/elecciones/elecciones2014/presidente/2v/99PR2/DPR2399999_L1.htm,30,30,9176,4600,4529,40,4569,26,5,4310,94.33,219,4.79
POTOSI,NARIÑO,http://www3.registraduria.gov.co/elecciones/elecciones2014/presidente/2v/99PR2/DPR2310099_L1.htm,http://www3.registraduria.gov.co/elecciones/elecciones2014/presidente/2v/99PR2/DPR2399999_L1.htm,30,30,9206,4555,4323,119,4442,89,24,1622,36.51,2701,60.80
PROVIDENCIA,NARIÑO,http://www3.registraduria.gov.co/elecciones/elecciones2014/presidente/2v/99PR2/DPR2310199_L1.htm,http://www3.registraduria.gov.co/elecciones/elecciones2014/presidente/2v/99PR2/DPR2399999_L1.htm,11,11,4069,2293,2215,41,2256,23,14,2031,90.02,184,8.15
PUERRES,NARIÑO,http://www3.registraduria.gov.co/elecciones/elecciones2014/presidente/2v/99PR2/DPR2310399_L1.htm,http://www3.registraduria.gov.co/elecciones/elecciones2014/presidente/2v/99PR2/DPR2399999_L1.htm,20,20,7341,4114,3859,137,3996,95,23,2068,51.75,1791,44.81
PUPIALES,NARIÑO,http://www3.registraduria.gov.co/elecciones/elecciones2014/presidente/2v/99PR2/DPR2310699_L1.htm,http://www3.registraduria.gov.co/elecciones/elecciones2014/presidente/2v/99PR2/DPR2399999_L1.htm,36,36,13807,8113,7450,325,7775,262,76,2601,33.45,4849,62.36
RICAURTE,NARIÑO,http://www3.registraduria.gov.co/elecciones/elecciones2014/presidente/2v/99PR2/DPR2310999_L1.htm,http://www3.registraduria.gov.co/elecciones/elecciones2014/presidente/2v/99PR2/DPR2399999_L1.htm,41,41,12081,4472,4224,70,4294,108,70,3549,82.65,675,15.71
ROBERTO PAYAN (SAN JOSE),NARIÑO,http://www3.registraduria.gov.co/elecciones/elecciones2014/presidente/2v/99PR2/DPR2311299_L1.htm,http://www3.registraduria.gov.co/elecciones/elecciones2014/presidente/2v/99PR2/DPR2399999_L1.htm,31,31,8074,3463,3414,13,3427,23,13,3206,93.55,208,6.06
SAMANIEGO,NARIÑO,http://www3.registraduria.gov.co/elecciones/elecciones2014/presidente/2v/99PR2/DPR2311599_L1.htm,http://www3.registraduria.gov.co/elecciones/elecciones2014/presidente/2v/99PR2/DPR2399999_L1.htm,69,69,21532,11838,11541,156,11697,109,32,10611,90.71,930,7.95
SAN BERNARDO,NARIÑO,http://www3.registraduria.gov.co/elecciones/elecciones2014/presidente/2v/99PR2/DPR2312099_L1.htm,http://www3.registraduria.gov.co/elecciones/elecciones2014/presidente/2v/99PR2/DPR2399999_L1.htm,16,16,5775,3784,3615,112,3727,34,23,1382,37.08,2233,59.91
SAN LORENZO,NARIÑO,http://www3.registraduria.gov.co/elecciones/elecciones2014/presidente/2v/99PR2/DPR2312199_L1.htm,http://www3.registraduria.gov.co/elecciones/elecciones2014/presidente/2v/99PR2/DPR2399999_L1.htm,34,34,12227,7227,6903,141,7044,121,62,3752,53.26,3151,44.73
SAN PABLO,NARIÑO,http://www3.registraduria.gov.co/elecciones/elecciones2014/presidente/2v/99PR2/DPR2312499_L1.htm,http://www3.registraduria.gov.co/elecciones/elecciones2014/presidente/2v/99PR2/DPR2399999_L1.htm,34,34,11013,6515,6104,203,6307,149,59,4000,63.42,2104,33.35
SAN PEDRO DE CARTAGO,NARIÑO,http://www3.registraduria.gov.co/elecciones/elecciones2014/presidente/2v/99PR2/DPR2312399_L1.htm,http://www3.registraduria.gov.co/elecciones/elecciones2014/presidente/2v/99PR2/DPR2399999_L1.htm,14,14,4949,2916,2771,79,2850,48,18,738,25.89,2033,71.33
SANDONA,NARIÑO,http://www3.registraduria.gov.co/elecciones/elecciones2014/presidente/2v/99PR2/DPR2311899_L1.htm,http://www3.registraduria.gov.co/elecciones/elecciones2014/presidente/2v/99PR2/DPR2399999_L1.htm,45,45,15441,9695,9377,164,9541,116,38,6974,73.09,2403,25.18
SANTA BARBARA (ISCUANDE),NARIÑO,http://www3.registraduria.gov.co/elecciones/elecciones2014/presidente/2v/99PR2/DPR2312599_L1.htm,http://www3.registraduria.gov.co/elecciones/elecciones2014/presidente/2v/99PR2/DPR2399999_L1.htm,23,23,6940,2227,2200,6,2206,20,1,1977,89.61,223,10.10
SANTACRUZ (GUACHAVES),NARIÑO,http://www3.registraduria.gov.co/elecciones/elecciones2014/presidente/2v/99PR2/DPR2312799_L1.htm,http://www3.registraduria.gov.co/elecciones/elecciones2014/presidente/2v/99PR2/DPR2399999_L1.htm,20,20,6393,3211,3141,41,3182,11,18,2856,89.75,285,8.95
SAPUYES,NARIÑO,http://www3.registraduria.gov.co/elecciones/elecciones2014/presidente/2v/99PR2/DPR2313099_L1.htm,http://www3.registraduria.gov.co/elecciones/elecciones2014/presidente/2v/99PR2/DPR2399999_L1.htm,16,16,5341,3045,2955,45,3000,35,10,1838,61.26,1117,37.23
TAMINANGO,NARIÑO,http://www3.registraduria.gov.co/elecciones/elecciones2014/presidente/2v/99PR2/DPR2313399_L1.htm,http://www3.registraduria.gov.co/elecciones/elecciones2014/presidente/2v/99PR2/DPR2399999_L1.htm,37,37,13277,7003,6727,158,6885,86,32,5218,75.78,1509,21.91
TANGUA,NARIÑO,http://www3.registraduria.gov.co/elecciones/elecciones2014/presidente/2v/99PR2/DPR2313699_L1.htm,http://www3.registraduria.gov.co/elecciones/elecciones2014/presidente/2v/99PR2/DPR2399999_L1.htm,28,28,9114,4820,4664,66,4730,68,22,3208,67.82,1456,30.78
TUMACO,NARIÑO,http://www3.registraduria.gov.co/elecciones/elecciones2014/presidente/2v/99PR2/DPR2313999_L1.htm,http://www3.registraduria.gov.co/elecciones/elecciones2014/presidente/2v/99PR2/DPR2399999_L1.htm,409,409,115142,48433,46452,995,47447,776,210,30696,64.69,15756,33.20
TUQUERRES,NARIÑO,http://www3.registraduria.gov.co/elecciones/elecciones2014/presidente/2v/99PR2/DPR2314299_L1.htm,http://www3.registraduria.gov.co/elecciones/elecciones2014/presidente/2v/99PR2/DPR2399999_L1.htm,91,91,32670,16275,15367,430,15797,372,106,11379,72.03,3988,25.24
YACUANQUER,NARIÑO,http://www3.registraduria.gov.co/elecciones/elecciones2014/presidente/2v/99PR2/DPR2314599_L1.htm,http://www3.registraduria.gov.co/elecciones/elecciones2014/presidente/2v/99PR2/DPR2399999_L1.htm,23,23,7682,4760,4590,74,4664,68,28,3013,64.60,1577,33.81
ABREGO,NORTE DE SAN,http://www3.registraduria.gov.co/elecciones/elecciones2014/presidente/2v/99PR2/DPR2500499_L1.htm,http://www3.registraduria.gov.co/elecciones/elecciones2014/presidente/2v/99PR2/DPR2599999_L1.htm,62,62,19949,9220,8881,185,9066,108,46,3561,39.27,5320,58.68
ARBOLEDAS,NORTE DE SAN,http://www3.registraduria.gov.co/elecciones/elecciones2014/presidente/2v/99PR2/DPR2500799_L1.htm,http://www3.registraduria.gov.co/elecciones/elecciones2014/presidente/2v/99PR2/DPR2599999_L1.htm,21,21,6483,3861,3743,56,3799,46,16,1671,43.98,2072,54.54
BOCHALEMA,NORTE DE SAN,http://www3.registraduria.gov.co/elecciones/elecciones2014/presidente/2v/99PR2/DPR2501099_L1.htm,http://www3.registraduria.gov.co/elecciones/elecciones2014/presidente/2v/99PR2/DPR2599999_L1.htm,18,18,5751,3524,3349,91,3440,72,12,1731,50.31,1618,47.03
BUCARASICA,NORTE DE SAN,http://www3.registraduria.gov.co/elecciones/elecciones2014/presidente/2v/99PR2/DPR2501399_L1.htm,http://www3.registraduria.gov.co/elecciones/elecciones2014/presidente/2v/99PR2/DPR2599999_L1.htm,14,14,4178,1942,1836,59,1895,31,16,503,26.54,1333,70.34
CACHIRA,NORTE DE SAN,http://www3.registraduria.gov.co/elecciones/elecciones2014/presidente/2v/99PR2/DPR2501999_L1.htm,http://www3.registraduria.gov.co/elecciones/elecciones2014/presidente/2v/99PR2/DPR2599999_L1.htm,24,24,6850,3569,3482,42,3524,33,12,644,18.27,2838,80.53
CACOTA,NORTE DE SAN,http://www3.registraduria.gov.co/elecciones/elecciones2014/presidente/2v/99PR2/DPR2501699_L1.htm,http://www3.registraduria.gov.co/elecciones/elecciones2014/presidente/2v/99PR2/DPR2599999_L1.htm,7,7,2079,1139,1090,31,1121,13,5,360,32.11,730,65.12
CHINACOTA,NORTE DE SAN,http://www3.registraduria.gov.co/elecciones/elecciones2014/presidente/2v/99PR2/DPR2502899_L1.htm,http://www3.registraduria.gov.co/elecciones/elecciones2014/presidente/2v/99PR2/DPR2599999_L1.htm,29,29,10960,6471,5975,261,6236,217,18,2767,44.37,3208,51.44
CHITAGA,NORTE DE SAN,http://www3.registraduria.gov.co/elecciones/elecciones2014/presidente/2v/99PR2/DPR2503199_L1.htm,http://www3.registraduria.gov.co/elecciones/elecciones2014/presidente/2v/99PR2/DPR2599999_L1.htm,23,23,7275,3906,3720,77,3797,86,23,870,22.91,2850,75.05
CONVENCION,NORTE DE SAN,http://www3.registraduria.gov.co/elecciones/elecciones2014/presidente/2v/99PR2/DPR2502299_L1.htm,http://www3.registraduria.gov.co/elecciones/elecciones2014/presidente/2v/99PR2/DPR2599999_L1.htm,45,45,14990,4465,4239,122,4361,85,19,3018,69.20,1221,27.99
CUCUTA,NORTE DE SAN,http://www3.registraduria.gov.co/elecciones/elecciones2014/presidente/2v/99PR2/DPR2500199_L1.htm,http://www3.registraduria.gov.co/elecciones/elecciones2014/presidente/2v/99PR2/DPR2599999_L1.htm,1275,1275,505374,241807,226615,8828,235443,5936,428,124578,52.91,102037,43.33
CUCUTILLA,NORTE DE SAN,http://www3.registraduria.gov.co/elecciones/elecciones2014/presidente/2v/99PR2/DPR2502599_L1.htm,http://www3.registraduria.gov.co/elecciones/elecciones2014/presidente/2v/99PR2/DPR2599999_L1.htm,17,17,5945,3334,3160,75,3235,63,36,1303,40.27,1857,57.40
DURANIA,NORTE DE SAN,http://www3.registraduria.gov.co/elecciones/elecciones2014/presidente/2v/99PR2/DPR2503499_L1.htm,http://www3.registraduria.gov.co/elecciones/elecciones2014/presidente/2v/99PR2/DPR2599999_L1.htm,13,13,4245,2313,2233,45,2278,33,2,1359,59.65,874,38.36
EL CARMEN,NORTE DE SAN,http://www3.registraduria.gov.co/elecciones/elecciones2014/presidente/2v/99PR2/DPR2503799_L1.htm,http://www3.registraduria.gov.co/elecciones/elecciones2014/presidente/2v/99PR2/DPR2599999_L1.htm,37,37,9740,4045,3902,67,3969,62,14,2327,58.62,1575,39.68
EL TARRA,NORTE DE SAN,http://www3.registraduria.gov.co/elecciones/elecciones2014/presidente/2v/99PR2/DPR2503699_L1.htm,http://www3.registraduria.gov.co/elecciones/elecciones2014/presidente/2v/99PR2/DPR2599999_L1.htm,27,27,9103,3662,3569,38,3607,48,7,3417,94.73,152,4.21
EL ZULIA,NORTE DE SAN,http://www3.registraduria.gov.co/elecciones/elecciones2014/presidente/2v/99PR2/DPR2503899_L1.htm,http://www3.registraduria.gov.co/elecciones/elecciones2014/presidente/2v/99PR2/DPR2599999_L1.htm,51,51,19070,9336,8823,280,9103,207,26,5199,57.11,3624,39.81
GRAMALOTE,NORTE DE SAN,http://www3.registraduria.gov.co/elecciones/elecciones2014/presidente/2v/99PR2/DPR2504099_L1.htm,http://www3.registraduria.gov.co/elecciones/elecciones2014/presidente/2v/99PR2/DPR2599999_L1.htm,14,14,4729,2735,2612,62,2674,41,20,1079,40.35,1533,57.32
HACARI,NORTE DE SAN,http://www3.registraduria.gov.co/elecciones/elecciones2014/presidente/2v/99PR2/DPR2504399_L1.htm,http://www3.registraduria.gov.co/elecciones/elecciones2014/presidente/2v/99PR2/DPR2599999_L1.htm,20,20,6370,2855,2740,55,2795,54,6,2571,91.98,169,6.04
HERRAN,NORTE DE SAN,http://www3.registraduria.gov.co/elecciones/elecciones2014/presidente/2v/99PR2/DPR2504699_L1.htm,http://www3.registraduria.gov.co/elecciones/elecciones2014/presidente/2v/99PR2/DPR2599999_L1.htm,10,10,3270,1360,1294,22,1316,35,9,476,36.17,818,62.15
LA ESPERANZA,NORTE DE SAN,http://www3.registraduria.gov.co/elecciones/elecciones2014/presidente/2v/99PR2/DPR2505199_L1.htm,http://www3.registraduria.gov.co/elecciones/elecciones2014/presidente/2v/99PR2/DPR2599999_L1.htm,26,26,7876,3663,3530,55,3585,65,13,1314,36.65,2216,61.81
LA PLAYA,NORTE DE SAN,http://www3.registraduria.gov.co/elecciones/elecciones2014/presidente/2v/99PR2/DPR2505299_L1.htm,http://www3.registraduria.gov.co/elecciones/elecciones2014/presidente/2v/99PR2/DPR2599999_L1.htm,18,18,6562,2507,2428,38,2466,32,9,1345,54.54,1083,43.91
LABATECA,NORTE DE SAN,http://www3.registraduria.gov.co/elecciones/elecciones2014/presidente/2v/99PR2/DPR2504999_L1.htm,http://www3.registraduria.gov.co/elecciones/elecciones2014/presidente/2v/99PR2/DPR2599999_L1.htm,14,14,4719,2402,2313,35,2348,42,12,988,42.07,1325,56.43
LOS PATIOS,NORTE DE SAN,http://www3.registraduria.gov.co/elecciones/elecciones2014/presidente/2v/99PR2/DPR2505499_L1.htm,http://www3.registraduria.gov.co/elecciones/elecciones2014/presidente/2v/99PR2/DPR2599999_L1.htm,183,183,74525,32161,30156,1114,31270,834,57,15035,48.08,15121,48.35
LOURDES,NORTE DE SAN,http://www3.registraduria.gov.co/elecciones/elecciones2014/presidente/2v/99PR2/DPR2505599_L1.htm,http://www3.registraduria.gov.co/elecciones/elecciones2014/presidente/2v/99PR2/DPR2599999_L1.htm,8,8,3120,1715,1643,39,1682,29,4,412,24.49,1231,73.18
MUTISCUA,NORTE DE SAN,http://www3.registraduria.gov.co/elecciones/elecciones2014/presidente/2v/99PR2/DPR2505899_L1.htm,http://www3.registraduria.gov.co/elecciones/elecciones2014/presidente/2v/99PR2/DPR2599999_L1.htm,8,8,2626,1641,1579,30,1609,15,17,528,32.81,1051,65.32
OCAÑA,NORTE DE SAN,http://www3.registraduria.gov.co/elecciones/elecciones2014/presidente/2v/99PR2/DPR2506199_L1.htm,http://www3.registraduria.gov.co/elecciones/elecciones2014/presidente/2v/99PR2/DPR2599999_L1.htm,174,174,71961,32517,30565,1182,31747,678,92,15101,47.56,15464,48.71
PAMPLONA,NORTE DE SAN,http://www3.registraduria.gov.co/elecciones/elecciones2014/presidente/2v/99PR2/DPR2506499_L1.htm,http://www3.registraduria.gov.co/elecciones/elecciones2014/presidente/2v/99PR2/DPR2599999_L1.htm,91,91,41439,21244,18979,1202,20181,1001,62,7777,38.53,11202,55.50
PAMPLONITA,NORTE DE SAN,http://www3.registraduria.gov.co/elecciones/elecciones2014/presidente/2v/99PR2/DPR2506799_L1.htm,http://www3.registraduria.gov.co/elecciones/elecciones2014/presidente/2v/99PR2/DPR2599999_L1.htm,11,11,3617,2343,2152,87,2239,85,19,519,23.17,1633,72.93
PUERTO SANTANDER,NORTE DE SAN,http://www3.registraduria.gov.co/elecciones/elecciones2014/presidente/2v/99PR2/DPR2506999_L1.htm,http://www3.registraduria.gov.co/elecciones/elecciones2014/presidente/2v/99PR2/DPR2599999_L1.htm,29,29,11393,3772,3667,52,3719,30,23,1572,42.26,2095,56.33
RAGONVALIA,NORTE DE SAN,http://www3.registraduria.gov.co/elecciones/elecciones2014/presidente/2v/99PR2/DPR2507099_L1.htm,http://www3.registraduria.gov.co/elecciones/elecciones2014/presidente/2v/99PR2/DPR2599999_L1.htm,16,16,5875,2209,2098,55,2153,39,17,809,37.57,1289,59.86
SALAZAR,NORTE DE SAN,http://www3.registraduria.gov.co/elecciones/elecciones2014/presidente/2v/99PR2/DPR2507399_L1.htm,http://www3.registraduria.gov.co/elecciones/elecciones2014/presidente/2v/99PR2/DPR2599999_L1.htm,23,23,7509,4078,3836,105,3941,110,27,1906,48.36,1930,48.97
SAN CALIXTO,NORTE DE SAN,http://www3.registraduria.gov.co/elecciones/elecciones2014/presidente/2v/99PR2/DPR2507699_L1.htm,http://www3.registraduria.gov.co/elecciones/elecciones2014/presidente/2v/99PR2/DPR2599999_L1.htm,26,26,6704,2853,2747,80,2827,22,4,2654,93.88,93,3.28
SAN CAYETANO,NORTE DE SAN,http://www3.registraduria.gov.co/elecciones/elecciones2014/presidente/2v/99PR2/DPR2507999_L1.htm,http://www3.registraduria.gov.co/elecciones/elecciones2014/presidente/2v/99PR2/DPR2599999_L1.htm,18,18,6409,3058,2948,50,2998,52,8,1676,55.90,1272,42.42
SANTIAGO,NORTE DE SAN,http://www3.registraduria.gov.co/elecciones/elecciones2014/presidente/2v/99PR2/DPR2508299_L1.htm,http://www3.registraduria.gov.co/elecciones/elecciones2014/presidente/2v/99PR2/DPR2599999_L1.htm,10,10,3231,1825,1775,27,1802,20,3,1007,55.88,768,42.61
SARDINATA,NORTE DE SAN,http://www3.registraduria.gov.co/elecciones/elecciones2014/presidente/2v/99PR2/DPR2508599_L1.htm,http://www3.registraduria.gov.co/elecciones/elecciones2014/presidente/2v/99PR2/DPR2599999_L1.htm,59,59,16809,6983,6595,196,6791,137,55,2689,39.59,3906,57.51
SILOS,NORTE DE SAN,http://www3.registraduria.gov.co/elecciones/elecciones2014/presidente/2v/99PR2/DPR2508899_L1.htm,http://www3.registraduria.gov.co/elecciones/elecciones2014/presidente/2v/99PR2/DPR2599999_L1.htm,12,12,3874,2198,2123,32,2155,30,13,343,15.91,1780,82.59
TEORAMA,NORTE DE SAN,http://www3.registraduria.gov.co/elecciones/elecciones2014/presidente/2v/99PR2/DPR2509199_L1.htm,http://www3.registraduria.gov.co/elecciones/elecciones2014/presidente/2v/99PR2/DPR2599999_L1.htm,27,27,8328,3001,2893,65,2958,31,12,2592,87.62,301,10.17
TIBU,NORTE DE SAN,http://www3.registraduria.gov.co/elecciones/elecciones2014/presidente/2v/99PR2/DPR2509399_L1.htm,http://www3.registraduria.gov.co/elecciones/elecciones2014/presidente/2v/99PR2/DPR2599999_L1.htm,79,79,28248,10349,9880,256,10136,175,38,7469,73.68,2411,23.78
TOLEDO,NORTE DE SAN,http://www3.registraduria.gov.co/elecciones/elecciones2014/presidente/2v/99PR2/DPR2509499_L1.htm,http://www3.registraduria.gov.co/elecciones/elecciones2014/presidente/2v/99PR2/DPR2599999_L1.htm,36,36,11851,6059,5661,195,5856,167,36,1693,28.91,3968,67.75
VILLA CARO,NORTE DE SAN,http://www3.registraduria.gov.co/elecciones/elecciones2014/presidente/2v/99PR2/DPR2509799_L1.htm,http://www3.registraduria.gov.co/elecciones/elecciones2014/presidente/2v/99PR2/DPR2599999_L1.htm,10,10,3596,1739,1680,24,1704,24,11,374,21.94,1306,76.64
VILLA DEL ROSARIO,NORTE DE SAN,http://www3.registraduria.gov.co/elecciones/elecciones2014/presidente/2v/99PR2/DPR2510099_L1.htm,http://www3.registraduria.gov.co/elecciones/elecciones2014/presidente/2v/99PR2/DPR2599999_L1.htm,174,174,74615,30565,28962,880,29842,664,59,14302,47.92,14660,49.12
COLON,PUTUMAYO,http://www3.registraduria.gov.co/elecciones/elecciones2014/presidente/2v/99PR2/DPR6400799_L1.htm,http://www3.registraduria.gov.co/elecciones/elecciones2014/presidente/2v/99PR2/DPR6499999_L1.htm,11,11,3985,2275,2187,60,2247,18,10,1241,55.22,946,42.10
MOCOA,PUTUMAYO,http://www3.registraduria.gov.co/elecciones/elecciones2014/presidente/2v/99PR2/DPR6400199_L1.htm,http://www3.registraduria.gov.co/elecciones/elecciones2014/presidente/2v/99PR2/DPR6499999_L1.htm,89,89,32512,16551,15463,722,16185,318,48,9136,56.44,6327,39.09
ORITO,PUTUMAYO,http://www3.registraduria.gov.co/elecciones/elecciones2014/presidente/2v/99PR2/DPR6402399_L1.htm,http://www3.registraduria.gov.co/elecciones/elecciones2014/presidente/2v/99PR2/DPR6499999_L1.htm,65,65,24004,11336,10875,239,11114,173,49,9248,83.21,1627,14.63
PUERTO ASIS,PUTUMAYO,http://www3.registraduria.gov.co/elecciones/elecciones2014/presidente/2v/99PR2/DPR6400299_L1.htm,http://www3.registraduria.gov.co/elecciones/elecciones2014/presidente/2v/99PR2/DPR6499999_L1.htm,103,103,37843,15451,14510,590,15100,276,75,9191,60.86,5319,35.22
PUERTO CAICEDO,PUTUMAYO,http://www3.registraduria.gov.co/elecciones/elecciones2014/presidente/2v/99PR2/DPR6402699_L1.htm,http://www3.registraduria.gov.co/elecciones/elecciones2014/presidente/2v/99PR2/DPR6499999_L1.htm,25,25,8272,3899,3696,125,3821,52,26,3187,83.40,509,13.32
PUERTO GUZMAN,PUTUMAYO,http://www3.registraduria.gov.co/elecciones/elecciones2014/presidente/2v/99PR2/DPR6402599_L1.htm,http://www3.registraduria.gov.co/elecciones/elecciones2014/presidente/2v/99PR2/DPR6499999_L1.htm,31,31,10298,3565,3352,154,3506,40,19,2079,59.29,1273,36.30
PUERTO LEGUIZAMO,PUTUMAYO,http://www3.registraduria.gov.co/elecciones/elecciones2014/presidente/2v/99PR2/DPR6400499_L1.htm,http://www3.registraduria.gov.co/elecciones/elecciones2014/presidente/2v/99PR2/DPR6499999_L1.htm,37,37,13346,4321,4130,102,4232,59,30,1938,45.79,2192,51.79
SAN FRANCISCO,PUTUMAYO,http://www3.registraduria.gov.co/elecciones/elecciones2014/presidente/2v/99PR2/DPR6401399_L1.htm,http://www3.registraduria.gov.co/elecciones/elecciones2014/presidente/2v/99PR2/DPR6499999_L1.htm,12,12,4485,2500,2366,92,2458,32,10,1339,54.47,1027,41.78
SAN MIGUEL (LA DORADA),PUTUMAYO,http://www3.registraduria.gov.co/elecciones/elecciones2014/presidente/2v/99PR2/DPR6401899_L1.htm,http://www3.registraduria.gov.co/elecciones/elecciones2014/presidente/2v/99PR2/DPR6499999_L1.htm,29,29,10804,4674,4542,53,4595,48,31,4216,91.75,326,7.09
SANTIAGO,PUTUMAYO,http://www3.registraduria.gov.co/elecciones/elecciones2014/presidente/2v/99PR2/DPR6401699_L1.htm,http://www3.registraduria.gov.co/elecciones/elecciones2014/presidente/2v/99PR2/DPR6499999_L1.htm,15,15,5657,2550,2424,65,2489,38,23,1478,59.38,946,38.00
SIBUNDOY,PUTUMAYO,http://www3.registraduria.gov.co/elecciones/elecciones2014/presidente/2v/99PR2/DPR6401999_L1.htm,http://www3.registraduria.gov.co/elecciones/elecciones2014/presidente/2v/99PR2/DPR6499999_L1.htm,25,25,9846,5327,5017,230,5247,65,15,2986,56.90,2031,38.70
VALLE DEL GUAMUEZ (LA HORMIGA),PUTUMAYO,http://www3.registraduria.gov.co/elecciones/elecciones2014/presidente/2v/99PR2/DPR6402899_L1.htm,http://www3.registraduria.gov.co/elecciones/elecciones2014/presidente/2v/99PR2/DPR6499999_L1.htm,58,58,21666,10136,9901,121,10022,82,32,9166,91.45,735,7.33
VILLAGARZON,PUTUMAYO,http://www3.registraduria.gov.co/elecciones/elecciones2014/presidente/2v/99PR2/DPR6403099_L1.htm,http://www3.registraduria.gov.co/elecciones/elecciones2014/presidente/2v/99PR2/DPR6499999_L1.htm,40,40,14140,6749,6291,260,6551,155,43,3356,51.22,2935,44.80
ARMENIA,QUINDIO,http://www3.registraduria.gov.co/elecciones/elecciones2014/presidente/2v/99PR2/DPR2600199_L1.htm,http://www3.registraduria.gov.co/elecciones/elecciones2014/presidente/2v/99PR2/DPR2699999_L1.htm,603,603,236387,123098,110906,7206,118112,4659,327,54391,46.05,56515,47.84
BUENAVISTA,QUINDIO,http://www3.registraduria.gov.co/elecciones/elecciones2014/presidente/2v/99PR2/DPR2600599_L1.htm,http://www3.registraduria.gov.co/elecciones/elecciones2014/presidente/2v/99PR2/DPR2699999_L1.htm,8,8,2786,1552,1482,29,1511,30,11,713,47.18,769,50.89
CALARCA,QUINDIO,http://www3.registraduria.gov.co/elecciones/elecciones2014/presidente/2v/99PR2/DPR2601099_L1.htm,http://www3.registraduria.gov.co/elecciones/elecciones2014/presidente/2v/99PR2/DPR2699999_L1.htm,145,145,55831,30592,27909,1353,29262,1220,110,11771,40.22,16138,55.15
CIRCASIA,QUINDIO,http://www3.registraduria.gov.co/elecciones/elecciones2014/presidente/2v/99PR2/DPR2602099_L1.htm,http://www3.registraduria.gov.co/elecciones/elecciones2014/presidente/2v/99PR2/DPR2699999_L1.htm,58,58,21111,12474,11466,556,12022,406,46,4954,41.20,6512,54.16
CORDOBA,QUINDIO,http://www3.registraduria.gov.co/elecciones/elecciones2014/presidente/2v/99PR2/DPR2602599_L1.htm,http://www3.registraduria.gov.co/elecciones/elecciones2014/presidente/2v/99PR2/DPR2699999_L1.htm,13,13,4815,2712,2578,53,2631,63,18,1361,51.72,1217,46.25
FILANDIA,QUINDIO,http://www3.registraduria.gov.co/elecciones/elecciones2014/presidente/2v/99PR2/DPR2603099_L1.htm,http://www3.registraduria.gov.co/elecciones/elecciones2014/presidente/2v/99PR2/DPR2699999_L1.htm,28,28,9842,5564,5154,204,5358,174,32,2143,39.99,3011,56.19
GENOVA,QUINDIO,http://www3.registraduria.gov.co/elecciones/elecciones2014/presidente/2v/99PR2/DPR2604099_L1.htm,http://www3.registraduria.gov.co/elecciones/elecciones2014/presidente/2v/99PR2/DPR2699999_L1.htm,19,19,7107,3828,3589,110,3699,103,26,1433,38.74,2156,58.28
LA TEBAIDA,QUINDIO,http://www3.registraduria.gov.co/elecciones/elecciones2014/presidente/2v/99PR2/DPR2605099_L1.htm,http://www3.registraduria.gov.co/elecciones/elecciones2014/presidente/2v/99PR2/DPR2699999_L1.htm,71,71,26127,14393,13155,497,13652,681,60,6645,48.67,6510,47.68
MONTENEGRO,QUINDIO,http://www3.registraduria.gov.co/elecciones/elecciones2014/presidente/2v/99PR2/DPR2606099_L1.htm,http://www3.registraduria.gov.co/elecciones/elecciones2014/presidente/2v/99PR2/DPR2699999_L1.htm,80,80,31843,16862,15321,686,16007,768,87,6824,42.63,8497,53.08
PIJAO,QUINDIO,http://www3.registraduria.gov.co/elecciones/elecciones2014/presidente/2v/99PR2/DPR2607099_L1.htm,http://www3.registraduria.gov.co/elecciones/elecciones2014/presidente/2v/99PR2/DPR2699999_L1.htm,18,18,5976,3155,3000,67,3067,69,19,1172,38.21,1828,59.60
QUIMBAYA,QUINDIO,http://www3.registraduria.gov.co/elecciones/elecciones2014/presidente/2v/99PR2/DPR2608099_L1.htm,http://www3.registraduria.gov.co/elecciones/elecciones2014/presidente/2v/99PR2/DPR2699999_L1.htm,71,71,28768,14991,13835,561,14396,521,74,7317,50.82,6518,45.27
SALENTO,QUINDIO,http://www3.registraduria.gov.co/elecciones/elecciones2014/presidente/2v/99PR2/DPR2609099_L1.htm,http://www3.registraduria.gov.co/elecciones/elecciones2014/presidente/2v/99PR2/DPR2699999_L1.htm,17,17,5478,3096,2897,111,3008,81,7,1098,36.50,1799,59.80
APIA,RISARALDA,http://www3.registraduria.gov.co/elecciones/elecciones2014/presidente/2v/99PR2/DPR2400899_L1.htm,http://www3.registraduria.gov.co/elecciones/elecciones2014/presidente/2v/99PR2/DPR2499999_L1.htm,30,30,10259,5654,5226,207,5433,175,46,1434,26.39,3792,69.79
BALBOA,RISARALDA,http://www3.registraduria.gov.co/elecciones/elecciones2014/presidente/2v/99PR2/DPR2401399_L1.htm,http://www3.registraduria.gov.co/elecciones/elecciones2014/presidente/2v/99PR2/DPR2499999_L1.htm,15,15,5409,2988,2813,81,2894,80,14,1148,39.66,1665,57.53
BELEN DE UMBRIA,RISARALDA,http://www3.registraduria.gov.co/elecciones/elecciones2014/presidente/2v/99PR2/DPR2402199_L1.htm,http://www3.registraduria.gov.co/elecciones/elecciones2014/presidente/2v/99PR2/DPR2499999_L1.htm,57,57,20783,11202,10482,369,10851,291,60,1963,18.09,8519,78.50
DOSQUEBRADAS,RISARALDA,http://www3.registraduria.gov.co/elecciones/elecciones2014/presidente/2v/99PR2/DPR2402599_L1.htm,http://www3.registraduria.gov.co/elecciones/elecciones2014/presidente/2v/99PR2/DPR2499999_L1.htm,363,363,141950,76547,68036,4957,72993,3323,231,31883,43.67,36153,49.52
GUATICA,RISARALDA,http://www3.registraduria.gov.co/elecciones/elecciones2014/presidente/2v/99PR2/DPR2402999_L1.htm,http://www3.registraduria.gov.co/elecciones/elecciones2014/presidente/2v/99PR2/DPR2499999_L1.htm,28,28,10134,5739,5375,172,5547,157,35,909,16.38,4466,80.51
LA CELIA,RISARALDA,http://www3.registraduria.gov.co/elecciones/elecciones2014/presidente/2v/99PR2/DPR2403899_L1.htm,http://www3.registraduria.gov.co/elecciones/elecciones2014/presidente/2v/99PR2/DPR2499999_L1.htm,16,16,6287,3449,3219,107,3326,105,18,757,22.76,2462,74.02
LA VIRGINIA,RISARALDA,http://www3.registraduria.gov.co/elecciones/elecciones2014/presidente/2v/99PR2/DPR2404699_L1.htm,http://www3.registraduria.gov.co/elecciones/elecciones2014/presidente/2v/99PR2/DPR2499999_L1.htm,70,70,29774,14873,13514,711,14225,580,68,6860,48.22,6654,46.77
MARSELLA,RISARALDA,http://www3.registraduria.gov.co/elecciones/elecciones2014/presidente/2v/99PR2/DPR2405499_L1.htm,http://www3.registraduria.gov.co/elecciones/elecciones2014/presidente/2v/99PR2/DPR2499999_L1.htm,42,42,15270,8158,7581,276,7857,247,54,2244,28.56,5337,67.92
MISTRATO,RISARALDA,http://www3.registraduria.gov.co/elecciones/elecciones2014/presidente/2v/99PR2/DPR2406299_L1.htm,http://www3.registraduria.gov.co/elecciones/elecciones2014/presidente/2v/99PR2/DPR2499999_L1.htm,27,27,10418,5768,5360,171,5531,186,51,2566,46.39,2794,50.51
PEREIRA,RISARALDA,http://www3.registraduria.gov.co/elecciones/elecciones2014/presidente/2v/99PR2/DPR2400199_L1.htm,http://www3.registraduria.gov.co/elecciones/elecciones2014/presidente/2v/99PR2/DPR2499999_L1.htm,948,948,377378,194538,174319,12116,186435,7496,607,80963,43.42,93356,50.07
PUEBLO RICO,RISARALDA,http://www3.registraduria.gov.co/elecciones/elecciones2014/presidente/2v/99PR2/DPR2407099_L1.htm,http://www3.registraduria.gov.co/elecciones/elecciones2014/presidente/2v/99PR2/DPR2499999_L1.htm,22,22,8310,3953,3731,88,3819,73,61,2129,55.74,1602,41.94
QUINCHIA,RISARALDA,http://www3.registraduria.gov.co/elecciones/elecciones2014/presidente/2v/99PR2/DPR2407899_L1.htm,http://www3.registraduria.gov.co/elecciones/elecciones2014/presidente/2v/99PR2/DPR2499999_L1.htm,51,51,19061,10879,9867,405,10272,511,96,5142,50.05,4725,45.99
SANTA ROSA DE CABAL,RISARALDA,http://www3.registraduria.gov.co/elecciones/elecciones2014/presidente/2v/99PR2/DPR2408699_L1.htm,http://www3.registraduria.gov.co/elecciones/elecciones2014/presidente/2v/99PR2/DPR2499999_L1.htm,128,128,56234,31326,28023,1886,29909,1299,118,10227,34.19,17796,59.50
SANTUARIO,RISARALDA,http://www3.registraduria.gov.co/elecciones/elecciones2014/presidente/2v/99PR2/DPR2409499_L1.htm,http://www3.registraduria.gov.co/elecciones/elecciones2014/presidente/2v/99PR2/DPR2499999_L1.htm,36,36,12223,5837,5437,184,5621,178,38,1589,28.26,3848,68.45
PROVIDENCIA,SAN ANDRES,http://www3.registraduria.gov.co/elecciones/elecciones2014/presidente/2v/99PR2/DPR5600499_L1.htm,http://www3.registraduria.gov.co/elecciones/elecciones2014/presidente/2v/99PR2/DPR5699999_L1.htm,10,10,3876,1218,1179,33,1212,4,2,636,52.47,543,44.80
SAN ANDRES,SAN ANDRES,http://www3.registraduria.gov.co/elecciones/elecciones2014/presidente/2v/99PR2/DPR5600199_L1.htm,http://www3.registraduria.gov.co/elecciones/elecciones2014/presidente/2v/99PR2/DPR5699999_L1.htm,104,104,41767,9757,9308,339,9647,88,22,5137,53.24,4171,43.23
AGUADA,SANTANDER,http://www3.registraduria.gov.co/elecciones/elecciones2014/presidente/2v/99PR2/DPR2700499_L1.htm,http://www3.registraduria.gov.co/elecciones/elecciones2014/presidente/2v/99PR2/DPR2799999_L1.htm,4,4,1436,859,834,15,849,8,2,282,33.21,552,65.01
ALBANIA,SANTANDER,http://www3.registraduria.gov.co/elecciones/elecciones2014/presidente/2v/99PR2/DPR2700799_L1.htm,http://www3.registraduria.gov.co/elecciones/elecciones2014/presidente/2v/99PR2/DPR2799999_L1.htm,12,12,3308,1557,1502,19,1521,26,10,577,37.93,925,60.81
ARATOCA,SANTANDER,http://www3.registraduria.gov.co/elecciones/elecciones2014/presidente/2v/99PR2/DPR2701099_L1.htm,http://www3.registraduria.gov.co/elecciones/elecciones2014/presidente/2v/99PR2/DPR2799999_L1.htm,16,16,6190,3626,3420,110,3530,77,19,1518,43.00,1902,53.88
BARBOSA,SANTANDER,http://www3.registraduria.gov.co/elecciones/elecciones2014/presidente/2v/99PR2/DPR2701399_L1.htm,http://www3.registraduria.gov.co/elecciones/elecciones2014/presidente/2v/99PR2/DPR2799999_L1.htm,61,61,22974,11533,10797,351,11148,357,28,5781,51.85,5016,44.99
BARICHARA,SANTANDER,http://www3.registraduria.gov.co/elecciones/elecciones2014/presidente/2v/99PR2/DPR2701699_L1.htm,http://www3.registraduria.gov.co/elecciones/elecciones2014/presidente/2v/99PR2/DPR2799999_L1.htm,16,16,6110,3373,3158,120,3278,85,10,1205,36.76,1953,59.57
BARRANCABERMEJA,SANTANDER,http://www3.registraduria.gov.co/elecciones/elecciones2014/presidente/2v/99PR2/DPR2701999_L1.htm,http://www3.registraduria.gov.co/elecciones/elecciones2014/presidente/2v/99PR2/DPR2799999_L1.htm,416,416,155058,84619,80509,2272,82781,1710,128,61509,74.30,19000,22.95
BETULIA,SANTANDER,http://www3.registraduria.gov.co/elecciones/elecciones2014/presidente/2v/99PR2/DPR2702299_L1.htm,http://www3.registraduria.gov.co/elecciones/elecciones2014/presidente/2v/99PR2/DPR2799999_L1.htm,12,12,3871,1965,1837,69,1906,49,10,813,42.65,1024,53.72
BOLIVAR,SANTANDER,http://www3.registraduria.gov.co/elecciones/elecciones2014/presidente/2v/99PR2/DPR2702599_L1.htm,http://www3.registraduria.gov.co/elecciones/elecciones2014/presidente/2v/99PR2/DPR2799999_L1.htm,30,30,8586,4319,4082,106,4188,97,34,2024,48.32,2058,49.14
BUCARAMANGA,SANTANDER,http://www3.registraduria.gov.co/elecciones/elecciones2014/presidente/2v/99PR2/DPR2700199_L1.htm,http://www3.registraduria.gov.co/elecciones/elecciones2014/presidente/2v/99PR2/DPR2799999_L1.htm,1239,1239,475132,240328,223716,10627,234343,5699,286,131056,55.92,92660,39.54
CABRERA,SANTANDER,http://www3.registraduria.gov.co/elecciones/elecciones2014/presidente/2v/99PR2/DPR2702899_L1.htm,http://www3.registraduria.gov.co/elecciones/elecciones2014/presidente/2v/99PR2/DPR2799999_L1.htm,5,5,1607,925,895,24,919,5,1,389,42.32,506,55.05
CALIFORNIA,SANTANDER,http://www3.registraduria.gov.co/elecciones/elecciones2014/presidente/2v/99PR2/DPR2703199_L1.htm,http://www3.registraduria.gov.co/elecciones/elecciones2014/presidente/2v/99PR2/DPR2799999_L1.htm,4,4,1573,902,834,43,877,23,2,155,17.67,679,77.42
CAPITANEJO,SANTANDER,http://www3.registraduria.gov.co/elecciones/elecciones2014/presidente/2v/99PR2/DPR2703499_L1.htm,http://www3.registraduria.gov.co/elecciones/elecciones2014/presidente/2v/99PR2/DPR2799999_L1.htm,13,13,4833,2496,2399,45,2444,38,14,603,24.67,1796,73.48
CARCASI,SANTANDER,http://www3.registraduria.gov.co/elecciones/elecciones2014/presidente/2v/99PR2/DPR2703799_L1.htm,http://www3.registraduria.gov.co/elecciones/elecciones2014/presidente/2v/99PR2/DPR2799999_L1.htm,15,15,3644,2005,1945,27,1972,23,10,599,30.37,1346,68.25
CEPITA,SANTANDER,http://www3.registraduria.gov.co/elecciones/elecciones2014/presidente/2v/99PR2/DPR2704099_L1.htm,http://www3.registraduria.gov.co/elecciones/elecciones2014/presidente/2v/99PR2/DPR2799999_L1.htm,10,10,1800,1163,1130,10,1140,17,6,502,44.03,628,55.08
CERRITO,SANTANDER,http://www3.registraduria.gov.co/elecciones/elecciones2014/presidente/2v/99PR2/DPR2704399_L1.htm,http://www3.registraduria.gov.co/elecciones/elecciones2014/presidente/2v/99PR2/DPR2799999_L1.htm,12,12,4499,2619,2529,38,2567,45,7,1236,48.14,1293,50.37
CHARALA,SANTANDER,http://www3.registraduria.gov.co/elecciones/elecciones2014/presidente/2v/99PR2/DPR2706199_L1.htm,http://www3.registraduria.gov.co/elecciones/elecciones2014/presidente/2v/99PR2/DPR2799999_L1.htm,25,25,9582,5324,5109,123,5232,66,26,3680,70.33,1429,27.31
CHARTA,SANTANDER,http://www3.registraduria.gov.co/elecciones/elecciones2014/presidente/2v/99PR2/DPR2706499_L1.htm,http://www3.registraduria.gov.co/elecciones/elecciones2014/presidente/2v/99PR2/DPR2799999_L1.htm,11,11,3334,2077,2024,30,2054,18,5,576,28.04,1448,70.49
CHIMA,SANTANDER,http://www3.registraduria.gov.co/elecciones/elecciones2014/presidente/2v/99PR2/DPR2706799_L1.htm,http://www3.registraduria.gov.co/elecciones/elecciones2014/presidente/2v/99PR2/DPR2799999_L1.htm,7,7,2348,1363,1293,33,1326,28,9,660,49.77,633,47.73
CHIPATA,SANTANDER,http://www3.registraduria.gov.co/elecciones/elecciones2014/presidente/2v/99PR2/DPR2707099_L1.htm,http://www3.registraduria.gov.co/elecciones/elecciones2014/presidente/2v/99PR2/DPR2799999_L1.htm,11,11,4104,2107,2018,52,2070,23,14,1534,74.10,484,23.38
CIMITARRA,SANTANDER,http://www3.registraduria.gov.co/elecciones/elecciones2014/presidente/2v/99PR2/DPR2704599_L1.htm,http://www3.registraduria.gov.co/elecciones/elecciones2014/presidente/2v/99PR2/DPR2799999_L1.htm,74,74,26172,11771,10977,319,11296,422,53,5356,47.41,5621,49.76
CONCEPCION,SANTANDER,http://www3.registraduria.gov.co/elecciones/elecciones2014/presidente/2v/99PR2/DPR2704699_L1.htm,http://www3.registraduria.gov.co/elecciones/elecciones2014/presidente/2v/99PR2/DPR2799999_L1.htm,16,16,4786,2669,2558,64,2622,39,8,1042,39.74,1516,57.81
CONFINES,SANTANDER,http://www3.registraduria.gov.co/elecciones/elecciones2014/presidente/2v/99PR2/DPR2704999_L1.htm,http://www3.registraduria.gov.co/elecciones/elecciones2014/presidente/2v/99PR2/DPR2799999_L1.htm,6,6,2267,1375,1319,20,1339,26,10,491,36.66,828,61.83
CONTRATACION,SANTANDER,http://www3.registraduria.gov.co/elecciones/elecciones2014/presidente/2v/99PR2/DPR2705299_L1.htm,http://www3.registraduria.gov.co/elecciones/elecciones2014/presidente/2v/99PR2/DPR2799999_L1.htm,8,8,2770,1533,1443,50,1493,33,7,684,45.81,759,50.83
COROMORO,SANTANDER,http://www3.registraduria.gov.co/elecciones/elecciones2014/presidente/2v/99PR2/DPR2705599_L1.htm,http://www3.registraduria.gov.co/elecciones/elecciones2014/presidente/2v/99PR2/DPR2799999_L1.htm,11,11,4047,2374,2268,49,2317,37,20,1092,47.12,1176,50.75
CURITI,SANTANDER,http://www3.registraduria.gov.co/elecciones/elecciones2014/presidente/2v/99PR2/DPR2705899_L1.htm,http://www3.registraduria.gov.co/elecciones/elecciones2014/presidente/2v/99PR2/DPR2799999_L1.htm,24,24,8001,5098,4841,128,4969,105,24,2081,41.87,2760,55.54
EL CARMEN,SANTANDER,http://www3.registraduria.gov.co/elecciones/elecciones2014/presidente/2v/99PR2/DPR2707199_L1.htm,http://www3.registraduria.gov.co/elecciones/elecciones2014/presidente/2v/99PR2/DPR2799999_L1.htm,31,31,10423,5981,5663,149,5812,146,23,1380,23.74,4283,73.69
EL GUACAMAYO,SANTANDER,http://www3.registraduria.gov.co/elecciones/elecciones2014/presidente/2v/99PR2/DPR2707399_L1.htm,http://www3.registraduria.gov.co/elecciones/elecciones2014/presidente/2v/99PR2/DPR2799999_L1.htm,5,5,1584,935,896,18,914,20,1,451,49.34,445,48.68
EL PEÑON,SANTANDER,http://www3.registraduria.gov.co/elecciones/elecciones2014/presidente/2v/99PR2/DPR2707599_L1.htm,http://www3.registraduria.gov.co/elecciones/elecciones2014/presidente/2v/99PR2/DPR2799999_L1.htm,14,14,3174,1699,1619,36,1655,29,15,899,54.32,720,43.50
EL PLAYON,SANTANDER,http://www3.registraduria.gov.co/elecciones/elecciones2014/presidente/2v/99PR2/DPR2707499_L1.htm,http://www3.registraduria.gov.co/elecciones/elecciones2014/presidente/2v/99PR2/DPR2799999_L1.htm,37,37,11266,5600,5324,122,5446,124,30,2246,41.24,3078,56.51
ENCINO,SANTANDER,http://www3.registraduria.gov.co/elecciones/elecciones2014/presidente/2v/99PR2/DPR2707699_L1.htm,http://www3.registraduria.gov.co/elecciones/elecciones2014/presidente/2v/99PR2/DPR2799999_L1.htm,6,6,2040,1192,1164,14,1178,11,3,589,50.00,575,48.81
ENCISO,SANTANDER,http://www3.registraduria.gov.co/elecciones/elecciones2014/presidente/2v/99PR2/DPR2707999_L1.htm,http://www3.registraduria.gov.co/elecciones/elecciones2014/presidente/2v/99PR2/DPR2799999_L1.htm,13,13,3198,1805,1736,44,1780,19,6,953,53.53,783,43.98
FLORIAN,SANTANDER,http://www3.registraduria.gov.co/elecciones/elecciones2014/presidente/2v/99PR2/DPR2708099_L1.htm,http://www3.registraduria.gov.co/elecciones/elecciones2014/presidente/2v/99PR2/DPR2799999_L1.htm,16,16,4965,2389,2349,18,2367,14,8,1611,68.06,738,31.17
FLORIDABLANCA,SANTANDER,http://www3.registraduria.gov.co/elecciones/elecciones2014/presidente/2v/99PR2/DPR2708299_L1.htm,http://www3.registraduria.gov.co/elecciones/elecciones2014/presidente/2v/99PR2/DPR2799999_L1.htm,446,446,168816,95023,87958,4363,92321,2566,136,49345,53.44,38613,41.82
GALAN,SANTANDER,http://www3.registraduria.gov.co/elecciones/elecciones2014/presidente/2v/99PR2/DPR2708599_L1.htm,http://www3.registraduria.gov.co/elecciones/elecciones2014/presidente/2v/99PR2/DPR2799999_L1.htm,12,12,2471,1384,1342,22,1364,17,3,393,28.81,949,69.57
GAMBITA,SANTANDER,http://www3.registraduria.gov.co/elecciones/elecciones2014/presidente/2v/99PR2/DPR2708899_L1.htm,http://www3.registraduria.gov.co/elecciones/elecciones2014/presidente/2v/99PR2/DPR2799999_L1.htm,10,10,3193,1674,1608,32,1640,28,6,830,50.60,778,47.43
GIRON,SANTANDER,http://www3.registraduria.gov.co/elecciones/elecciones2014/presidente/2v/99PR2/DPR2709199_L1.htm,http://www3.registraduria.gov.co/elecciones/elecciones2014/presidente/2v/99PR2/DPR2799999_L1.htm,263,263,97590,53309,49473,2218,51691,1546,72,28073,54.30,21400,41.39
GUACA,SANTANDER,http://www3.registraduria.gov.co/elecciones/elecciones2014/presidente/2v/99PR2/DPR2709499_L1.htm,http://www3.registraduria.gov.co/elecciones/elecciones2014/presidente/2v/99PR2/DPR2799999_L1.htm,20,20,5171,2793,2690,54,2744,38,11,943,34.36,1747,63.66
GUADALUPE,SANTANDER,http://www3.registraduria.gov.co/elecciones/elecciones2014/presidente/2v/99PR2/DPR2709799_L1.htm,http://www3.registraduria.gov.co/elecciones/elecciones2014/presidente/2v/99PR2/DPR2799999_L1.htm,13,13,4204,2359,2229,64,2293,57,9,631,27.51,1598,69.69
GUAPOTA,SANTANDER,http://www3.registraduria.gov.co/elecciones/elecciones2014/presidente/2v/99PR2/DPR2710099_L1.htm,http://www3.registraduria.gov.co/elecciones/elecciones2014/presidente/2v/99PR2/DPR2799999_L1.htm,6,6,1842,1128,1083,19,1102,20,6,544,49.36,539,48.91
GUAVATA,SANTANDER,http://www3.registraduria.gov.co/elecciones/elecciones2014/presidente/2v/99PR2/DPR2710399_L1.htm,http://www3.registraduria.gov.co/elecciones/elecciones2014/presidente/2v/99PR2/DPR2799999_L1.htm,12,12,4446,2177,2080,47,2127,37,13,1183,55.61,897,42.17
GUEPSA,SANTANDER,http://www3.registraduria.gov.co/elecciones/elecciones2014/presidente/2v/99PR2/DPR2710699_L1.htm,http://www3.registraduria.gov.co/elecciones/elecciones2014/presidente/2v/99PR2/DPR2799999_L1.htm,11,11,4027,2004,1906,51,1957,35,12,1275,65.15,631,32.24
HATO,SANTANDER,http://www3.registraduria.gov.co/elecciones/elecciones2014/presidente/2v/99PR2/DPR2710999_L1.htm,http://www3.registraduria.gov.co/elecciones/elecciones2014/presidente/2v/99PR2/DPR2799999_L1.htm,5,5,1784,1090,1014,28,1042,42,6,668,64.10,346,33.20
JESUS MARIA,SANTANDER,http://www3.registraduria.gov.co/elecciones/elecciones2014/presidente/2v/99PR2/DPR2711299_L1.htm,http://www3.registraduria.gov.co/elecciones/elecciones2014/presidente/2v/99PR2/DPR2799999_L1.htm,10,10,3152,1562,1502,30,1532,28,2,748,48.82,754,49.21
JORDAN,SANTANDER,http://www3.registraduria.gov.co/elecciones/elecciones2014/presidente/2v/99PR2/DPR2711599_L1.htm,http://www3.registraduria.gov.co/elecciones/elecciones2014/presidente/2v/99PR2/DPR2799999_L1.htm,5,5,1018,640,620,11,631,5,4,96,15.21,524,83.04
LA BELLEZA,SANTANDER,http://www3.registraduria.gov.co/elecciones/elecciones2014/presidente/2v/99PR2/DPR2711999_L1.htm,http://www3.registraduria.gov.co/elecciones/elecciones2014/presidente/2v/99PR2/DPR2799999_L1.htm,15,15,5182,2629,2546,62,2608,16,5,617,23.65,1929,73.96
LA PAZ,SANTANDER,http://www3.registraduria.gov.co/elecciones/elecciones2014/presidente/2v/99PR2/DPR2711899_L1.htm,http://www3.registraduria.gov.co/elecciones/elecciones2014/presidente/2v/99PR2/DPR2799999_L1.htm,13,13,4077,1928,1852,46,1898,24,6,823,43.36,1029,54.21
LANDAZURI,SANTANDER,http://www3.registraduria.gov.co/elecciones/elecciones2014/presidente/2v/99PR2/DPR2712099_L1.htm,http://www3.registraduria.gov.co/elecciones/elecciones2014/presidente/2v/99PR2/DPR2799999_L1.htm,27,27,9218,4178,3913,129,4042,116,20,2142,52.99,1771,43.81
LEBRIJA,SANTANDER,http://www3.registraduria.gov.co/elecciones/elecciones2014/presidente/2v/99PR2/DPR2712199_L1.htm,http://www3.registraduria.gov.co/elecciones/elecciones2014/presidente/2v/99PR2/DPR2799999_L1.htm,78,78,28034,16099,15192,485,15677,383,39,6976,44.49,8216,52.40
LOS SANTOS,SANTANDER,http://www3.registraduria.gov.co/elecciones/elecciones2014/presidente/2v/99PR2/DPR2712499_L1.htm,http://www3.registraduria.gov.co/elecciones/elecciones2014/presidente/2v/99PR2/DPR2799999_L1.htm,24,24,8179,5023,4666,198,4864,142,17,2460,50.57,2206,45.35
MACARAVITA,SANTANDER,http://www3.registraduria.gov.co/elecciones/elecciones2014/presidente/2v/99PR2/DPR2712799_L1.htm,http://www3.registraduria.gov.co/elecciones/elecciones2014/presidente/2v/99PR2/DPR2799999_L1.htm,6,6,2189,1130,1104,13,1117,12,1,272,24.35,832,74.48
MALAGA,SANTANDER,http://www3.registraduria.gov.co/elecciones/elecciones2014/presidente/2v/99PR2/DPR2713099_L1.htm,http://www3.registraduria.gov.co/elecciones/elecciones2014/presidente/2v/99PR2/DPR2799999_L1.htm,43,43,14869,8202,7649,283,7932,257,13,3012,37.97,4637,58.45
MATANZA,SANTANDER,http://www3.registraduria.gov.co/elecciones/elecciones2014/presidente/2v/99PR2/DPR2713399_L1.htm,http://www3.registraduria.gov.co/elecciones/elecciones2014/presidente/2v/99PR2/DPR2799999_L1.htm,15,15,4847,2862,2745,60,2805,35,22,753,26.84,1992,71.01
MOGOTES,SANTANDER,http://www3.registraduria.gov.co/elecciones/elecciones2014/presidente/2v/99PR2/DPR2713699_L1.htm,http://www3.registraduria.gov.co/elecciones/elecciones2014/presidente/2v/99PR2/DPR2799999_L1.htm,23,23,7339,4007,3739,110,3849,141,17,1455,37.80,2284,59.34
MOLAGAVITA,SANTANDER,http://www3.registraduria.gov.co/elecciones/elecciones2014/presidente/2v/99PR2/DPR2713999_L1.htm,http://www3.registraduria.gov.co/elecciones/elecciones2014/presidente/2v/99PR2/DPR2799999_L1.htm,15,15,3571,1867,1794,40,1834,24,9,332,18.10,1462,79.71
OCAMONTE,SANTANDER,http://www3.registraduria.gov.co/elecciones/elecciones2014/presidente/2v/99PR2/DPR2714299_L1.htm,http://www3.registraduria.gov.co/elecciones/elecciones2014/presidente/2v/99PR2/DPR2799999_L1.htm,10,10,3677,2217,2154,32,2186,26,5,1028,47.02,1126,51.50
OIBA,SANTANDER,http://www3.registraduria.gov.co/elecciones/elecciones2014/presidente/2v/99PR2/DPR2714599_L1.htm,http://www3.registraduria.gov.co/elecciones/elecciones2014/presidente/2v/99PR2/DPR2799999_L1.htm,21,21,8124,4474,4212,129,4341,121,12,1693,39.00,2519,58.02
ONZAGA,SANTANDER,http://www3.registraduria.gov.co/elecciones/elecciones2014/presidente/2v/99PR2/DPR2714899_L1.htm,http://www3.registraduria.gov.co/elecciones/elecciones2014/presidente/2v/99PR2/DPR2799999_L1.htm,13,13,3793,1998,1899,36,1935,42,21,726,37.51,1173,60.62
PALMAR,SANTANDER,http://www3.registraduria.gov.co/elecciones/elecciones2014/presidente/2v/99PR2/DPR2715199_L1.htm,http://www3.registraduria.gov.co/elecciones/elecciones2014/presidente/2v/99PR2/DPR2799999_L1.htm,4,4,1308,747,722,11,733,13,1,468,63.84,254,34.65
PALMAS DEL SOCORRO,SANTANDER,http://www3.registraduria.gov.co/elecciones/elecciones2014/presidente/2v/99PR2/DPR2715499_L1.htm,http://www3.registraduria.gov.co/elecciones/elecciones2014/presidente/2v/99PR2/DPR2799999_L1.htm,7,7,2412,1382,1326,26,1352,21,9,630,46.59,696,51.47
PARAMO,SANTANDER,http://www3.registraduria.gov.co/elecciones/elecciones2014/presidente/2v/99PR2/DPR2715799_L1.htm,http://www3.registraduria.gov.co/elecciones/elecciones2014/presidente/2v/99PR2/DPR2799999_L1.htm,9,9,2977,2023,1926,47,1973,46,4,664,33.65,1262,63.96
PIEDECUESTA,SANTANDER,http://www3.registraduria.gov.co/elecciones/elecciones2014/presidente/2v/99PR2/DPR2716099_L1.htm,http://www3.registraduria.gov.co/elecciones/elecciones2014/presidente/2v/99PR2/DPR2799999_L1.htm,252,252,93023,53602,49543,2178,51721,1763,118,26498,51.23,23045,44.55
PINCHOTE,SANTANDER,http://www3.registraduria.gov.co/elecciones/elecciones2014/presidente/2v/99PR2/DPR2716399_L1.htm,http://www3.registraduria.gov.co/elecciones/elecciones2014/presidente/2v/99PR2/DPR2799999_L1.htm,8,8,2917,1786,1699,47,1746,35,5,747,42.78,952,54.52
PUENTE NACIONAL,SANTANDER,http://www3.registraduria.gov.co/elecciones/elecciones2014/presidente/2v/99PR2/DPR2716699_L1.htm,http://www3.registraduria.gov.co/elecciones/elecciones2014/presidente/2v/99PR2/DPR2799999_L1.htm,38,38,12323,5922,5612,166,5778,134,10,2973,51.45,2639,45.67
PUERTO PARRA,SANTANDER,http://www3.registraduria.gov.co/elecciones/elecciones2014/presidente/2v/99PR2/DPR2716799_L1.htm,http://www3.registraduria.gov.co/elecciones/elecciones2014/presidente/2v/99PR2/DPR2799999_L1.htm,16,16,5211,2255,2118,63,2181,56,18,1001,45.89,1117,51.21
PUERTO WILCHES,SANTANDER,http://www3.registraduria.gov.co/elecciones/elecciones2014/presidente/2v/99PR2/DPR2716999_L1.htm,http://www3.registraduria.gov.co/elecciones/elecciones2014/presidente/2v/99PR2/DPR2799999_L1.htm,63,63,22147,11014,10578,194,10772,206,36,6563,60.92,4015,37.27
RIONEGRO,SANTANDER,http://www3.registraduria.gov.co/elecciones/elecciones2014/presidente/2v/99PR2/DPR2717299_L1.htm,http://www3.registraduria.gov.co/elecciones/elecciones2014/presidente/2v/99PR2/DPR2799999_L1.htm,64,64,21094,10822,10223,309,10532,256,34,4746,45.06,5477,52.00
SABANA DE TORRES,SANTANDER,http://www3.registraduria.gov.co/elecciones/elecciones2014/presidente/2v/99PR2/DPR2717499_L1.htm,http://www3.registraduria.gov.co/elecciones/elecciones2014/presidente/2v/99PR2/DPR2799999_L1.htm,49,49,19187,9658,9127,270,9397,220,41,4697,49.98,4430,47.14
SAN ANDRES,SANTANDER,http://www3.registraduria.gov.co/elecciones/elecciones2014/presidente/2v/99PR2/DPR2717599_L1.htm,http://www3.registraduria.gov.co/elecciones/elecciones2014/presidente/2v/99PR2/DPR2799999_L1.htm,25,25,6944,3824,3677,72,3749,50,25,1496,39.90,2181,58.17
SAN BENITO,SANTANDER,http://www3.registraduria.gov.co/elecciones/elecciones2014/presidente/2v/99PR2/DPR2717899_L1.htm,http://www3.registraduria.gov.co/elecciones/elecciones2014/presidente/2v/99PR2/DPR2799999_L1.htm,9,9,2933,1460,1424,21,1445,12,3,783,54.18,641,44.35
SAN GIL,SANTANDER,http://www3.registraduria.gov.co/elecciones/elecciones2014/presidente/2v/99PR2/DPR2718199_L1.htm,http://www3.registraduria.gov.co/elecciones/elecciones2014/presidente/2v/99PR2/DPR2799999_L1.htm,108,108,37904,20658,19122,927,20049,591,18,9931,49.53,9191,45.84
SAN JOAQUIN,SANTANDER,http://www3.registraduria.gov.co/elecciones/elecciones2014/presidente/2v/99PR2/DPR2718499_L1.htm,http://www3.registraduria.gov.co/elecciones/elecciones2014/presidente/2v/99PR2/DPR2799999_L1.htm,6,6,2185,1153,1099,26,1125,19,9,514,45.68,585,52.00
SAN JOSE DE MIRANDA,SANTANDER,http://www3.registraduria.gov.co/elecciones/elecciones2014/presidente/2v/99PR2/DPR2718799_L1.htm,http://www3.registraduria.gov.co/elecciones/elecciones2014/presidente/2v/99PR2/DPR2799999_L1.htm,13,13,3863,2248,2144,59,2203,33,12,536,24.33,1608,72.99
SAN MIGUEL,SANTANDER,http://www3.registraduria.gov.co/elecciones/elecciones2014/presidente/2v/99PR2/DPR2719099_L1.htm,http://www3.registraduria.gov.co/elecciones/elecciones2014/presidente/2v/99PR2/DPR2799999_L1.htm,9,9,2093,1127,1097,16,1113,8,6,336,30.18,761,68.37
SAN VICENTE DE CHUCURI,SANTANDER,http://www3.registraduria.gov.co/elecciones/elecciones2014/presidente/2v/99PR2/DPR2719399_L1.htm,http://www3.registraduria.gov.co/elecciones/elecciones2014/presidente/2v/99PR2/DPR2799999_L1.htm,69,69,24221,11988,11173,450,11623,326,39,4359,37.50,6814,58.62
SANTA BARBARA,SANTANDER,http://www3.registraduria.gov.co/elecciones/elecciones2014/presidente/2v/99PR2/DPR2719599_L1.htm,http://www3.registraduria.gov.co/elecciones/elecciones2014/presidente/2v/99PR2/DPR2799999_L1.htm,7,7,1853,1174,1122,25,1147,19,8,385,33.56,737,64.25
SANTA HELENA DEL OPON,SANTANDER,http://www3.registraduria.gov.co/elecciones/elecciones2014/presidente/2v/99PR2/DPR2719499_L1.htm,http://www3.registraduria.gov.co/elecciones/elecciones2014/presidente/2v/99PR2/DPR2799999_L1.htm,10,10,2989,1508,1403,79,1482,21,5,606,40.89,797,53.77
SIMACOTA,SANTANDER,http://www3.registraduria.gov.co/elecciones/elecciones2014/presidente/2v/99PR2/DPR2719699_L1.htm,http://www3.registraduria.gov.co/elecciones/elecciones2014/presidente/2v/99PR2/DPR2799999_L1.htm,17,17,5705,3177,3044,62,3106,52,19,1572,50.61,1472,47.39
SOCORRO,SANTANDER,http://www3.registraduria.gov.co/elecciones/elecciones2014/presidente/2v/99PR2/DPR2719999_L1.htm,http://www3.registraduria.gov.co/elecciones/elecciones2014/presidente/2v/99PR2/DPR2799999_L1.htm,59,59,22206,12337,11676,393,12069,249,19,6021,49.88,5655,46.85
SUAITA,SANTANDER,http://www3.registraduria.gov.co/elecciones/elecciones2014/presidente/2v/99PR2/DPR2720299_L1.htm,http://www3.registraduria.gov.co/elecciones/elecciones2014/presidente/2v/99PR2/DPR2799999_L1.htm,24,24,8148,4040,3821,113,3934,93,13,2333,59.30,1488,37.82
SUCRE,SANTANDER,http://www3.registraduria.gov.co/elecciones/elecciones2014/presidente/2v/99PR2/DPR2720599_L1.htm,http://www3.registraduria.gov.co/elecciones/elecciones2014/presidente/2v/99PR2/DPR2799999_L1.htm,20,20,5917,2907,2798,58,2856,45,6,813,28.46,1985,69.50
SURATA,SANTANDER,http://www3.registraduria.gov.co/elecciones/elecciones2014/presidente/2v/99PR2/DPR2720899_L1.htm,http://www3.registraduria.gov.co/elecciones/elecciones2014/presidente/2v/99PR2/DPR2799999_L1.htm,10,10,2803,1638,1554,38,1592,36,10,545,34.23,1009,63.37
TONA,SANTANDER,http://www3.registraduria.gov.co/elecciones/elecciones2014/presidente/2v/99PR2/DPR2721199_L1.htm,http://www3.registraduria.gov.co/elecciones/elecciones2014/presidente/2v/99PR2/DPR2799999_L1.htm,13,13,4873,2849,2672,86,2758,79,12,1423,51.59,1249,45.28
VALLE DE SAN JOSE,SANTANDER,http://www3.registraduria.gov.co/elecciones/elecciones2014/presidente/2v/99PR2/DPR2721799_L1.htm,http://www3.registraduria.gov.co/elecciones/elecciones2014/presidente/2v/99PR2/DPR2799999_L1.htm,13,13,4381,2756,2639,62,2701,50,5,1161,42.98,1478,54.72
VELEZ,SANTANDER,http://www3.registraduria.gov.co/elecciones/elecciones2014/presidente/2v/99PR2/DPR2722099_L1.htm,http://www3.registraduria.gov.co/elecciones/elecciones2014/presidente/2v/99PR2/DPR2799999_L1.htm,45,45,15968,8359,7784,262,8046,283,30,4650,57.79,3134,38.95
VETAS,SANTANDER,http://www3.registraduria.gov.co/elecciones/elecciones2014/presidente/2v/99PR2/DPR2721999_L1.htm,http://www3.registraduria.gov.co/elecciones/elecciones2014/presidente/2v/99PR2/DPR2799999_L1.htm,4,4,1430,848,800,29,829,19,0,117,14.11,683,82.38
VILLANUEVA,SANTANDER,http://www3.registraduria.gov.co/elecciones/elecciones2014/presidente/2v/99PR2/DPR2722199_L1.htm,http://www3.registraduria.gov.co/elecciones/elecciones2014/presidente/2v/99PR2/DPR2799999_L1.htm,16,16,6217,3481,3301,118,3419,51,11,1093,31.96,2208,64.58
ZAPATOCA,SANTANDER,http://www3.registraduria.gov.co/elecciones/elecciones2014/presidente/2v/99PR2/DPR2722399_L1.htm,http://www3.registraduria.gov.co/elecciones/elecciones2014/presidente/2v/99PR2/DPR2799999_L1.htm,19,19,7120,3511,3302,112,3414,86,11,1103,32.30,2199,64.41
BUENAVISTA,SUCRE,http://www3.registraduria.gov.co/elecciones/elecciones2014/presidente/2v/99PR2/DPR2801099_L1.htm,http://www3.registraduria.gov.co/elecciones/elecciones2014/presidente/2v/99PR2/DPR2899999_L1.htm,24,24,9190,4977,4881,56,4937,27,13,3658,74.09,1223,24.77
CAIMITO,SUCRE,http://www3.registraduria.gov.co/elecciones/elecciones2014/presidente/2v/99PR2/DPR2802099_L1.htm,http://www3.registraduria.gov.co/elecciones/elecciones2014/presidente/2v/99PR2/DPR2899999_L1.htm,28,28,8397,4995,4916,33,4949,36,10,3910,79.00,1006,20.32
CHALAN,SUCRE,http://www3.registraduria.gov.co/elecciones/elecciones2014/presidente/2v/99PR2/DPR2804599_L1.htm,http://www3.registraduria.gov.co/elecciones/elecciones2014/presidente/2v/99PR2/DPR2899999_L1.htm,12,12,4352,2446,2406,20,2426,13,7,1263,52.06,1143,47.11
COLOSO (RICAURTE),SUCRE,http://www3.registraduria.gov.co/elecciones/elecciones2014/presidente/2v/99PR2/DPR2803099_L1.htm,http://www3.registraduria.gov.co/elecciones/elecciones2014/presidente/2v/99PR2/DPR2899999_L1.htm,19,19,6486,3776,3692,36,3728,28,20,2257,60.54,1435,38.49
COROZAL,SUCRE,http://www3.registraduria.gov.co/elecciones/elecciones2014/presidente/2v/99PR2/DPR2804099_L1.htm,http://www3.registraduria.gov.co/elecciones/elecciones2014/presidente/2v/99PR2/DPR2899999_L1.htm,111,111,44135,24030,23242,484,23726,282,22,14187,59.79,9055,38.16
COVEÑAS,SUCRE,http://www3.registraduria.gov.co/elecciones/elecciones2014/presidente/2v/99PR2/DPR2804199_L1.htm,http://www3.registraduria.gov.co/elecciones/elecciones2014/presidente/2v/99PR2/DPR2899999_L1.htm,28,28,10050,6384,6138,131,6269,96,19,3812,60.80,2326,37.10
EL ROBLE,SUCRE,http://www3.registraduria.gov.co/elecciones/elecciones2014/presidente/2v/99PR2/DPR2804299_L1.htm,http://www3.registraduria.gov.co/elecciones/elecciones2014/presidente/2v/99PR2/DPR2899999_L1.htm,26,26,7466,4173,4116,25,4141,23,9,3076,74.28,1040,25.11
GALERAS (NUEVA GRANADA),SUCRE,http://www3.registraduria.gov.co/elecciones/elecciones2014/presidente/2v/99PR2/DPR2804899_L1.htm,http://www3.registraduria.gov.co/elecciones/elecciones2014/presidente/2v/99PR2/DPR2899999_L1.htm,41,41,15009,8401,8197,113,8310,65,26,4506,54.22,3691,44.41
GUARANDA,SUCRE,http://www3.registraduria.gov.co/elecciones/elecciones2014/presidente/2v/99PR2/DPR2804999_L1.htm,http://www3.registraduria.gov.co/elecciones/elecciones2014/presidente/2v/99PR2/DPR2899999_L1.htm,34,34,12014,6502,6385,52,6437,50,15,2722,42.28,3663,56.90
LA UNION,SUCRE,http://www3.registraduria.gov.co/elecciones/elecciones2014/presidente/2v/99PR2/DPR2805099_L1.htm,http://www3.registraduria.gov.co/elecciones/elecciones2014/presidente/2v/99PR2/DPR2899999_L1.htm,28,28,9166,5068,4976,55,5031,27,10,3806,75.65,1170,23.25
LOS PALMITOS,SUCRE,http://www3.registraduria.gov.co/elecciones/elecciones2014/presidente/2v/99PR2/DPR2805599_L1.htm,http://www3.registraduria.gov.co/elecciones/elecciones2014/presidente/2v/99PR2/DPR2899999_L1.htm,46,46,16691,10368,10185,89,10274,76,18,7385,71.88,2800,27.25
MAJAGUAL,SUCRE,http://www3.registraduria.gov.co/elecciones/elecciones2014/presidente/2v/99PR2/DPR2806099_L1.htm,http://www3.registraduria.gov.co/elecciones/elecciones2014/presidente/2v/99PR2/DPR2899999_L1.htm,78,78,25071,14145,13914,90,14004,104,37,6968,49.75,6946,49.60
MORROA,SUCRE,http://www3.registraduria.gov.co/elecciones/elecciones2014/presidente/2v/99PR2/DPR2808099_L1.htm,http://www3.registraduria.gov.co/elecciones/elecciones2014/presidente/2v/99PR2/DPR2899999_L1.htm,36,36,12154,7005,6802,115,6917,68,20,4070,58.84,2732,39.49
OVEJAS,SUCRE,http://www3.registraduria.gov.co/elecciones/elecciones2014/presidente/2v/99PR2/DPR2810099_L1.htm,http://www3.registraduria.gov.co/elecciones/elecciones2014/presidente/2v/99PR2/DPR2899999_L1.htm,57,57,19495,10955,10728,106,10834,96,25,6749,62.29,3979,36.72
PALMITO,SUCRE,http://www3.registraduria.gov.co/elecciones/elecciones2014/presidente/2v/99PR2/DPR2812099_L1.htm,http://www3.registraduria.gov.co/elecciones/elecciones2014/presidente/2v/99PR2/DPR2899999_L1.htm,29,29,9233,5307,5193,45,5238,52,17,3552,67.81,1641,31.32
SAMPUES,SUCRE,http://www3.registraduria.gov.co/elecciones/elecciones2014/presidente/2v/99PR2/DPR2816099_L1.htm,http://www3.registraduria.gov.co/elecciones/elecciones2014/presidente/2v/99PR2/DPR2899999_L1.htm,81,81,29234,17630,17167,239,17406,181,43,12252,70.38,4915,28.23
SAN BENITO ABAD,SUCRE,http://www3.registraduria.gov.co/elecciones/elecciones2014/presidente/2v/99PR2/DPR2818099_L1.htm,http://www3.registraduria.gov.co/elecciones/elecciones2014/presidente/2v/99PR2/DPR2899999_L1.htm,56,56,17776,9534,9368,60,9428,81,25,5279,55.99,4089,43.37
SAN JUAN DE BETULIA (BETULIA),SUCRE,http://www3.registraduria.gov.co/elecciones/elecciones2014/presidente/2v/99PR2/DPR2819099_L1.htm,http://www3.registraduria.gov.co/elecciones/elecciones2014/presidente/2v/99PR2/DPR2899999_L1.htm,32,32,10833,6578,6405,102,6507,56,15,4208,64.66,2197,33.76
SAN MARCOS,SUCRE,http://www3.registraduria.gov.co/elecciones/elecciones2014/presidente/2v/99PR2/DPR2820099_L1.htm,http://www3.registraduria.gov.co/elecciones/elecciones2014/presidente/2v/99PR2/DPR2899999_L1.htm,109,109,40135,19878,19373,218,19591,228,59,11107,56.69,8266,42.19
SAN ONOFRE,SUCRE,http://www3.registraduria.gov.co/elecciones/elecciones2014/presidente/2v/99PR2/DPR2822099_L1.htm,http://www3.registraduria.gov.co/elecciones/elecciones2014/presidente/2v/99PR2/DPR2899999_L1.htm,113,113,39570,16439,16045,144,16189,189,61,12211,75.42,3834,23.68
SAN PEDRO,SUCRE,http://www3.registraduria.gov.co/elecciones/elecciones2014/presidente/2v/99PR2/DPR2824099_L1.htm,http://www3.registraduria.gov.co/elecciones/elecciones2014/presidente/2v/99PR2/DPR2899999_L1.htm,42,42,15727,8676,8439,136,8575,76,25,5350,62.39,3089,36.02
SINCE,SUCRE,http://www3.registraduria.gov.co/elecciones/elecciones2014/presidente/2v/99PR2/DPR2826099_L1.htm,http://www3.registraduria.gov.co/elecciones/elecciones2014/presidente/2v/99PR2/DPR2899999_L1.htm,70,70,24765,12860,12450,215,12665,165,30,8080,63.79,4370,34.50
SINCELEJO,SUCRE,http://www3.registraduria.gov.co/elecciones/elecciones2014/presidente/2v/99PR2/DPR2800199_L1.htm,http://www3.registraduria.gov.co/elecciones/elecciones2014/presidente/2v/99PR2/DPR2899999_L1.htm,462,462,184217,94917,90940,2458,93398,1330,189,49534,53.03,41406,44.33
SUCRE,SUCRE,http://www3.registraduria.gov.co/elecciones/elecciones2014/presidente/2v/99PR2/DPR2828099_L1.htm,http://www3.registraduria.gov.co/elecciones/elecciones2014/presidente/2v/99PR2/DPR2899999_L1.htm,67,67,19826,9977,9824,54,9878,70,29,5168,52.31,4656,47.13
TOLU,SUCRE,http://www3.registraduria.gov.co/elecciones/elecciones2014/presidente/2v/99PR2/DPR2830099_L1.htm,http://www3.registraduria.gov.co/elecciones/elecciones2014/presidente/2v/99PR2/DPR2899999_L1.htm,59,59,21937,11420,11003,227,11230,160,30,7301,65.01,3702,32.96
TOLUVIEJO,SUCRE,http://www3.registraduria.gov.co/elecciones/elecciones2014/presidente/2v/99PR2/DPR2832099_L1.htm,http://www3.registraduria.gov.co/elecciones/elecciones2014/presidente/2v/99PR2/DPR2899999_L1.htm,49,49,17338,9875,9667,125,9792,61,22,7013,71.61,2654,27.10
ALPUJARRA,TOLIMA,http://www3.registraduria.gov.co/elecciones/elecciones2014/presidente/2v/99PR2/DPR2900499_L1.htm,http://www3.registraduria.gov.co/elecciones/elecciones2014/presidente/2v/99PR2/DPR2999999_L1.htm,12,12,3585,1962,1900,25,1925,31,6,302,15.68,1598,83.01
ALVARADO,TOLIMA,http://www3.registraduria.gov.co/elecciones/elecciones2014/presidente/2v/99PR2/DPR2900799_L1.htm,http://www3.registraduria.gov.co/elecciones/elecciones2014/presidente/2v/99PR2/DPR2999999_L1.htm,23,23,8110,3984,3808,80,3888,74,22,2014,51.80,1794,46.14
AMBALEMA,TOLIMA,http://www3.registraduria.gov.co/elecciones/elecciones2014/presidente/2v/99PR2/DPR2901099_L1.htm,http://www3.registraduria.gov.co/elecciones/elecciones2014/presidente/2v/99PR2/DPR2999999_L1.htm,21,21,6900,3183,3028,70,3098,74,11,1956,63.13,1072,34.60
ANZOATEGUI,TOLIMA,http://www3.registraduria.gov.co/elecciones/elecciones2014/presidente/2v/99PR2/DPR2901399_L1.htm,http://www3.registraduria.gov.co/elecciones/elecciones2014/presidente/2v/99PR2/DPR2999999_L1.htm,20,20,7114,3464,3320,56,3376,66,22,503,14.89,2817,83.44
ARMERO (GUAYABAL),TOLIMA,http://www3.registraduria.gov.co/elecciones/elecciones2014/presidente/2v/99PR2/DPR2901699_L1.htm,http://www3.registraduria.gov.co/elecciones/elecciones2014/presidente/2v/99PR2/DPR2999999_L1.htm,27,27,9969,4901,4650,97,4747,133,21,2577,54.28,2073,43.66
ATACO,TOLIMA,http://www3.registraduria.gov.co/elecciones/elecciones2014/presidente/2v/99PR2/DPR2901999_L1.htm,http://www3.registraduria.gov.co/elecciones/elecciones2014/presidente/2v/99PR2/DPR2999999_L1.htm,47,47,14531,7473,7292,85,7377,69,27,1299,17.60,5993,81.23
CAJAMARCA,TOLIMA,http://www3.registraduria.gov.co/elecciones/elecciones2014/presidente/2v/99PR2/DPR2902299_L1.htm,http://www3.registraduria.gov.co/elecciones/elecciones2014/presidente/2v/99PR2/DPR2999999_L1.htm,42,42,15993,8296,7704,293,7997,262,37,1663,20.79,6041,75.54
CARMEN DE APICALA,TOLIMA,http://www3.registraduria.gov.co/elecciones/elecciones2014/presidente/2v/99PR2/DPR2902599_L1.htm,http://www3.registraduria.gov.co/elecciones/elecciones2014/presidente/2v/99PR2/DPR2999999_L1.htm,21,21,8031,4679,4491,93,4584,82,13,2116,46.16,2375,51.81
CASABIANCA,TOLIMA,http://www3.registraduria.gov.co/elecciones/elecciones2014/presidente/2v/99PR2/DPR2902899_L1.htm,http://www3.registraduria.gov.co/elecciones/elecciones2014/presidente/2v/99PR2/DPR2999999_L1.htm,13,13,4763,2510,2392,53,2445,50,15,575,23.51,1817,74.31
CHAPARRAL,TOLIMA,http://www3.registraduria.gov.co/elecciones/elecciones2014/presidente/2v/99PR2/DPR2904099_L1.htm,http://www3.registraduria.gov.co/elecciones/elecciones2014/presidente/2v/99PR2/DPR2999999_L1.htm,87,87,36209,15615,14959,342,15301,250,64,5655,36.95,9304,60.80
COELLO,TOLIMA,http://www3.registraduria.gov.co/elecciones/elecciones2014/presidente/2v/99PR2/DPR2903199_L1.htm,http://www3.registraduria.gov.co/elecciones/elecciones2014/presidente/2v/99PR2/DPR2999999_L1.htm,22,22,7607,3808,3666,71,3737,56,15,2261,60.50,1405,37.59
COYAIMA,TOLIMA,http://www3.registraduria.gov.co/elecciones/elecciones2014/presidente/2v/99PR2/DPR2903499_L1.htm,http://www3.registraduria.gov.co/elecciones/elecciones2014/presidente/2v/99PR2/DPR2999999_L1.htm,44,44,16594,8341,7972,92,8064,139,138,5018,62.22,2954,36.63
CUNDAY,TOLIMA,http://www3.registraduria.gov.co/elecciones/elecciones2014/presidente/2v/99PR2/DPR2903799_L1.htm,http://www3.registraduria.gov.co/elecciones/elecciones2014/presidente/2v/99PR2/DPR2999999_L1.htm,23,23,7066,3464,3370,34,3404,41,19,865,25.41,2505,73.58
DOLORES,TOLIMA,http://www3.registraduria.gov.co/elecciones/elecciones2014/presidente/2v/99PR2/DPR2904399_L1.htm,http://www3.registraduria.gov.co/elecciones/elecciones2014/presidente/2v/99PR2/DPR2999999_L1.htm,19,19,6440,3183,3065,49,3114,56,13,736,23.63,2329,74.79
ESPINAL,TOLIMA,http://www3.registraduria.gov.co/elecciones/elecciones2014/presidente/2v/99PR2/DPR2904699_L1.htm,http://www3.registraduria.gov.co/elecciones/elecciones2014/presidente/2v/99PR2/DPR2999999_L1.htm,141,141,55765,31925,29907,1094,31001,835,89,14002,45.16,15905,51.30
FALAN,TOLIMA,http://www3.registraduria.gov.co/elecciones/elecciones2014/presidente/2v/99PR2/DPR2904999_L1.htm,http://www3.registraduria.gov.co/elecciones/elecciones2014/presidente/2v/99PR2/DPR2999999_L1.htm,15,15,5684,3041,2909,66,2975,42,24,1531,51.46,1378,46.31
FLANDES,TOLIMA,http://www3.registraduria.gov.co/elecciones/elecciones2014/presidente/2v/99PR2/DPR2905299_L1.htm,http://www3.registraduria.gov.co/elecciones/elecciones2014/presidente/2v/99PR2/DPR2999999_L1.htm,44,44,16676,8860,8341,252,8593,232,35,3817,44.41,4524,52.64
FRESNO,TOLIMA,http://www3.registraduria.gov.co/elecciones/elecciones2014/presidente/2v/99PR2/DPR2905599_L1.htm,http://www3.registraduria.gov.co/elecciones/elecciones2014/presidente/2v/99PR2/DPR2999999_L1.htm,74,74,25411,12288,11502,361,11863,351,74,2536,21.37,8966,75.57
GUAMO,TOLIMA,http://www3.registraduria.gov.co/elecciones/elecciones2014/presidente/2v/99PR2/DPR2905899_L1.htm,http://www3.registraduria.gov.co/elecciones/elecciones2014/presidente/2v/99PR2/DPR2999999_L1.htm,71,71,25217,12527,11958,286,12244,235,48,3891,31.77,8067,65.88
HERVEO,TOLIMA,http://www3.registraduria.gov.co/elecciones/elecciones2014/presidente/2v/99PR2/DPR2906199_L1.htm,http://www3.registraduria.gov.co/elecciones/elecciones2014/presidente/2v/99PR2/DPR2999999_L1.htm,19,19,6014,2989,2841,55,2896,70,23,590,20.37,2251,77.72
HONDA,TOLIMA,http://www3.registraduria.gov.co/elecciones/elecciones2014/presidente/2v/99PR2/DPR2906499_L1.htm,http://www3.registraduria.gov.co/elecciones/elecciones2014/presidente/2v/99PR2/DPR2999999_L1.htm,51,51,22579,10554,9835,345,10180,334,40,4876,47.89,4959,48.71
IBAGUE,TOLIMA,http://www3.registraduria.gov.co/elecciones/elecciones2014/presidente/2v/99PR2/DPR2900199_L1.htm,http://www3.registraduria.gov.co/elecciones/elecciones2014/presidente/2v/99PR2/DPR2999999_L1.htm,934,934,370044,201187,183859,9793,193652,7189,346,69593,35.93,114266,59.00
ICONONZO,TOLIMA,http://www3.registraduria.gov.co/elecciones/elecciones2014/presidente/2v/99PR2/DPR2906799_L1.htm,http://www3.registraduria.gov.co/elecciones/elecciones2014/presidente/2v/99PR2/DPR2999999_L1.htm,23,23,8175,3998,3839,93,3932,57,9,2011,51.14,1828,46.49
LERIDA,TOLIMA,http://www3.registraduria.gov.co/elecciones/elecciones2014/presidente/2v/99PR2/DPR2907099_L1.htm,http://www3.registraduria.gov.co/elecciones/elecciones2014/presidente/2v/99PR2/DPR2999999_L1.htm,41,41,14781,7249,6859,231,7090,141,18,3860,54.44,2999,42.29
LIBANO,TOLIMA,http://www3.registraduria.gov.co/elecciones/elecciones2014/presidente/2v/99PR2/DPR2907399_L1.htm,http://www3.registraduria.gov.co/elecciones/elecciones2014/presidente/2v/99PR2/DPR2999999_L1.htm,77,77,32391,15542,14618,437,15055,410,77,5788,38.44,8830,58.65
MARIQUITA,TOLIMA,http://www3.registraduria.gov.co/elecciones/elecciones2014/presidente/2v/99PR2/DPR2907699_L1.htm,http://www3.registraduria.gov.co/elecciones/elecciones2014/presidente/2v/99PR2/DPR2999999_L1.htm,72,72,27396,14643,13603,458,14061,532,50,6022,42.82,7581,53.91
MELGAR,TOLIMA,http://www3.registraduria.gov.co/elecciones/elecciones2014/presidente/2v/99PR2/DPR2907999_L1.htm,http://www3.registraduria.gov.co/elecciones/elecciones2014/presidente/2v/99PR2/DPR2999999_L1.htm,69,69,25379,13281,12643,335,12978,276,27,3595,27.70,9048,69.71
MURILLO,TOLIMA,http://www3.registraduria.gov.co/elecciones/elecciones2014/presidente/2v/99PR2/DPR2908099_L1.htm,http://www3.registraduria.gov.co/elecciones/elecciones2014/presidente/2v/99PR2/DPR2999999_L1.htm,11,11,3676,1515,1398,64,1462,46,7,332,22.70,1066,72.91
NATAGAIMA,TOLIMA,http://www3.registraduria.gov.co/elecciones/elecciones2014/presidente/2v/99PR2/DPR2908299_L1.htm,http://www3.registraduria.gov.co/elecciones/elecciones2014/presidente/2v/99PR2/DPR2999999_L1.htm,42,42,15328,6920,6668,111,6779,116,25,3987,58.81,2681,39.54
ORTEGA,TOLIMA,http://www3.registraduria.gov.co/elecciones/elecciones2014/presidente/2v/99PR2/DPR2908599_L1.htm,http://www3.registraduria.gov.co/elecciones/elecciones2014/presidente/2v/99PR2/DPR2999999_L1.htm,69,69,23501,12189,11661,191,11852,254,83,3909,32.98,7752,65.40
PALOCABILDO,TOLIMA,http://www3.registraduria.gov.co/elecciones/elecciones2014/presidente/2v/99PR2/DPR2908799_L1.htm,http://www3.registraduria.gov.co/elecciones/elecciones2014/presidente/2v/99PR2/DPR2999999_L1.htm,18,18,6967,3613,3444,95,3539,48,26,1200,33.90,2244,63.40
PIEDRAS,TOLIMA,http://www3.registraduria.gov.co/elecciones/elecciones2014/presidente/2v/99PR2/DPR2908899_L1.htm,http://www3.registraduria.gov.co/elecciones/elecciones2014/presidente/2v/99PR2/DPR2999999_L1.htm,16,16,5387,2253,1778,380,2158,80,15,1065,49.35,713,33.03
PLANADAS,TOLIMA,http://www3.registraduria.gov.co/elecciones/elecciones2014/presidente/2v/99PR2/DPR2908999_L1.htm,http://www3.registraduria.gov.co/elecciones/elecciones2014/presidente/2v/99PR2/DPR2999999_L1.htm,53,53,18846,8169,7703,231,7934,195,40,2630,33.14,5073,63.94
PRADO,TOLIMA,http://www3.registraduria.gov.co/elecciones/elecciones2014/presidente/2v/99PR2/DPR2909199_L1.htm,http://www3.registraduria.gov.co/elecciones/elecciones2014/presidente/2v/99PR2/DPR2999999_L1.htm,23,23,7768,3978,3821,81,3902,58,18,1300,33.31,2521,64.60
PURIFICACION,TOLIMA,http://www3.registraduria.gov.co/elecciones/elecciones2014/presidente/2v/99PR2/DPR2909499_L1.htm,http://www3.registraduria.gov.co/elecciones/elecciones2014/presidente/2v/99PR2/DPR2999999_L1.htm,56,56,19909,10893,10321,259,10580,273,40,5360,50.66,4961,46.89
RIOBLANCO,TOLIMA,http://www3.registraduria.gov.co/elecciones/elecciones2014/presidente/2v/99PR2/DPR2909799_L1.htm,http://www3.registraduria.gov.co/elecciones/elecciones2014/presidente/2v/99PR2/DPR2999999_L1.htm,43,43,15251,5967,5650,173,5823,89,55,2052,35.23,3598,61.78
RONCESVALLES,TOLIMA,http://www3.registraduria.gov.co/elecciones/elecciones2014/presidente/2v/99PR2/DPR2910099_L1.htm,http://www3.registraduria.gov.co/elecciones/elecciones2014/presidente/2v/99PR2/DPR2999999_L1.htm,12,12,3970,1738,1644,38,1682,42,14,412,24.49,1232,73.24
ROVIRA,TOLIMA,http://www3.registraduria.gov.co/elecciones/elecciones2014/presidente/2v/99PR2/DPR2910399_L1.htm,http://www3.registraduria.gov.co/elecciones/elecciones2014/presidente/2v/99PR2/DPR2999999_L1.htm,55,55,18491,8282,7894,170,8064,164,54,1635,20.27,6259,77.61
SALDAÑA,TOLIMA,http://www3.registraduria.gov.co/elecciones/elecciones2014/presidente/2v/99PR2/DPR2910599_L1.htm,http://www3.registraduria.gov.co/elecciones/elecciones2014/presidente/2v/99PR2/DPR2999999_L1.htm,32,32,12288,6053,5673,189,5862,170,21,1886,32.17,3787,64.60
SAN ANTONIO,TOLIMA,http://www3.registraduria.gov.co/elecciones/elecciones2014/presidente/2v/99PR2/DPR2910699_L1.htm,http://www3.registraduria.gov.co/elecciones/elecciones2014/presidente/2v/99PR2/DPR2999999_L1.htm,27,27,9834,4901,4709,72,4781,99,21,610,12.75,4099,85.73
SAN LUIS,TOLIMA,http://www3.registraduria.gov.co/elecciones/elecciones2014/presidente/2v/99PR2/DPR2910999_L1.htm,http://www3.registraduria.gov.co/elecciones/elecciones2014/presidente/2v/99PR2/DPR2999999_L1.htm,31,31,10808,6181,5925,91,6016,135,30,2566,42.65,3359,55.83
SANTA ISABEL,TOLIMA,http://www3.registraduria.gov.co/elecciones/elecciones2014/presidente/2v/99PR2/DPR2911299_L1.htm,http://www3.registraduria.gov.co/elecciones/elecciones2014/presidente/2v/99PR2/DPR2999999_L1.htm,18,18,5857,2722,2611,61,2672,41,9,472,17.66,2139,80.05
SUAREZ,TOLIMA,http://www3.registraduria.gov.co/elecciones/elecciones2014/presidente/2v/99PR2/DPR2911599_L1.htm,http://www3.registraduria.gov.co/elecciones/elecciones2014/presidente/2v/99PR2/DPR2999999_L1.htm,12,12,4357,2372,2304,35,2339,26,7,1142,48.82,1162,49.67
VALLE DE SAN JUAN,TOLIMA,http://www3.registraduria.gov.co/elecciones/elecciones2014/presidente/2v/99PR2/DPR2911899_L1.htm,http://www3.registraduria.gov.co/elecciones/elecciones2014/presidente/2v/99PR2/DPR2999999_L1.htm,16,16,4967,2640,2534,48,2582,35,23,550,21.30,1984,76.83
VENADILLO,TOLIMA,http://www3.registraduria.gov.co/elecciones/elecciones2014/presidente/2v/99PR2/DPR2912199_L1.htm,http://www3.registraduria.gov.co/elecciones/elecciones2014/presidente/2v/99PR2/DPR2999999_L1.htm,31,31,11464,5528,5277,128,5405,103,20,2709,50.12,2568,47.51
VILLAHERMOSA,TOLIMA,http://www3.registraduria.gov.co/elecciones/elecciones2014/presidente/2v/99PR2/DPR2912499_L1.htm,http://www3.registraduria.gov.co/elecciones/elecciones2014/presidente/2v/99PR2/DPR2999999_L1.htm,23,23,7002,3566,3397,77,3474,72,20,521,14.99,2876,82.78
VILLARRICA,TOLIMA,http://www3.registraduria.gov.co/elecciones/elecciones2014/presidente/2v/99PR2/DPR2912799_L1.htm,http://www3.registraduria.gov.co/elecciones/elecciones2014/presidente/2v/99PR2/DPR2999999_L1.htm,16,16,5106,2441,2363,40,2403,23,15,506,21.05,1857,77.27
ALCALA,VALLE,http://www3.registraduria.gov.co/elecciones/elecciones2014/presidente/2v/99PR2/DPR3100499_L1.htm,http://www3.registraduria.gov.co/elecciones/elecciones2014/presidente/2v/99PR2/DPR3199999_L1.htm,29,29,10950,5044,4700,154,4854,161,29,2420,49.85,2280,46.97
ANDALUCIA,VALLE,http://www3.registraduria.gov.co/elecciones/elecciones2014/presidente/2v/99PR2/DPR3100799_L1.htm,http://www3.registraduria.gov.co/elecciones/elecciones2014/presidente/2v/99PR2/DPR3199999_L1.htm,52,52,19343,8986,8430,332,8762,205,19,5766,65.80,2664,30.40
ANSERMANUEVO,VALLE,http://www3.registraduria.gov.co/elecciones/elecciones2014/presidente/2v/99PR2/DPR3101099_L1.htm,http://www3.registraduria.gov.co/elecciones/elecciones2014/presidente/2v/99PR2/DPR3199999_L1.htm,59,59,19162,7977,7375,351,7726,204,47,1951,25.25,5424,70.20
ARGELIA,VALLE,http://www3.registraduria.gov.co/elecciones/elecciones2014/presidente/2v/99PR2/DPR3101399_L1.htm,http://www3.registraduria.gov.co/elecciones/elecciones2014/presidente/2v/99PR2/DPR3199999_L1.htm,20,20,6423,2817,2713,48,2761,41,15,1039,37.63,1674,60.63
BOLIVAR,VALLE,http://www3.registraduria.gov.co/elecciones/elecciones2014/presidente/2v/99PR2/DPR3101699_L1.htm,http://www3.registraduria.gov.co/elecciones/elecciones2014/presidente/2v/99PR2/DPR3199999_L1.htm,41,41,13257,5841,5483,192,5675,141,25,1994,35.13,3489,61.48
BUENAVENTURA,VALLE,http://www3.registraduria.gov.co/elecciones/elecciones2014/presidente/2v/99PR2/DPR3101999_L1.htm,http://www3.registraduria.gov.co/elecciones/elecciones2014/presidente/2v/99PR2/DPR3199999_L1.htm,547,547,207431,86526,82174,1978,84152,2137,237,66927,79.53,15247,18.11
BUGA,VALLE,http://www3.registraduria.gov.co/elecciones/elecciones2014/presidente/2v/99PR2/DPR3102299_L1.htm,http://www3.registraduria.gov.co/elecciones/elecciones2014/presidente/2v/99PR2/DPR3199999_L1.htm,250,250,95582,46984,43239,2234,45473,1422,89,29756,65.43,13483,29.65
BUGALAGRANDE,VALLE,http://www3.registraduria.gov.co/elecciones/elecciones2014/presidente/2v/99PR2/DPR3102599_L1.htm,http://www3.registraduria.gov.co/elecciones/elecciones2014/presidente/2v/99PR2/DPR3199999_L1.htm,58,58,19210,9606,9130,261,9391,194,21,6732,71.68,2398,25.53
CAICEDONIA,VALLE,http://www3.registraduria.gov.co/elecciones/elecciones2014/presidente/2v/99PR2/DPR3102899_L1.htm,http://www3.registraduria.gov.co/elecciones/elecciones2014/presidente/2v/99PR2/DPR3199999_L1.htm,79,79,28020,13119,12132,455,12587,460,72,3988,31.68,8144,64.70
CALI,VALLE,http://www3.registraduria.gov.co/elecciones/elecciones2014/presidente/2v/99PR2/DPR3100199_L1.htm,http://www3.registraduria.gov.co/elecciones/elecciones2014/presidente/2v/99PR2/DPR3199999_L1.htm,4339,4339,1549820,623976,579936,29307,609243,13876,857,377187,61.91,202749,33.27
CALIMA (DARIEN),VALLE,http://www3.registraduria.gov.co/elecciones/elecciones2014/presidente/2v/99PR2/DPR3104099_L1.htm,http://www3.registraduria.gov.co/elecciones/elecciones2014/presidente/2v/99PR2/DPR3199999_L1.htm,46,46,13672,5843,5441,235,5676,149,18,3102,54.65,2339,41.20
CANDELARIA,VALLE,http://www3.registraduria.gov.co/elecciones/elecciones2014/presidente/2v/99PR2/DPR3103199_L1.htm,http://www3.registraduria.gov.co/elecciones/elecciones2014/presidente/2v/99PR2/DPR3199999_L1.htm,164,164,65386,29843,27628,1126,28754,1008,81,20907,72.70,6721,23.37
CARTAGO,VALLE,http://www3.registraduria.gov.co/elecciones/elecciones2014/presidente/2v/99PR2/DPR3103499_L1.htm,http://www3.registraduria.gov.co/elecciones/elecciones2014/presidente/2v/99PR2/DPR3199999_L1.htm,280,280,108329,48521,43762,2782,46544,1820,157,19005,40.83,24757,53.19
DAGUA,VALLE,http://www3.registraduria.gov.co/elecciones/elecciones2014/presidente/2v/99PR2/DPR3103799_L1.htm,http://www3.registraduria.gov.co/elecciones/elecciones2014/presidente/2v/99PR2/DPR3199999_L1.htm,101,101,33433,16012,15284,358,15642,310,60,7939,50.75,7345,46.95
EL AGUILA,VALLE,http://www3.registraduria.gov.co/elecciones/elecciones2014/presidente/2v/99PR2/DPR3104399_L1.htm,http://www3.registraduria.gov.co/elecciones/elecciones2014/presidente/2v/99PR2/DPR3199999_L1.htm,31,31,8191,3891,3638,133,3771,94,26,539,14.29,3099,82.17
EL CAIRO,VALLE,http://www3.registraduria.gov.co/elecciones/elecciones2014/presidente/2v/99PR2/DPR3104699_L1.htm,http://www3.registraduria.gov.co/elecciones/elecciones2014/presidente/2v/99PR2/DPR3199999_L1.htm,22,22,6717,2814,2671,74,2745,54,15,699,25.46,1972,71.83
EL CERRITO,VALLE,http://www3.registraduria.gov.co/elecciones/elecciones2014/presidente/2v/99PR2/DPR3104999_L1.htm,http://www3.registraduria.gov.co/elecciones/elecciones2014/presidente/2v/99PR2/DPR3199999_L1.htm,130,130,51374,23215,21581,906,22487,669,59,16089,71.54,5492,24.42
EL DOVIO,VALLE,http://www3.registraduria.gov.co/elecciones/elecciones2014/presidente/2v/99PR2/DPR3105299_L1.htm,http://www3.registraduria.gov.co/elecciones/elecciones2014/presidente/2v/99PR2/DPR3199999_L1.htm,32,32,9688,4209,3965,108,4073,116,20,1940,47.63,2025,49.71
FLORIDA,VALLE,http://www3.registraduria.gov.co/elecciones/elecciones2014/presidente/2v/99PR2/DPR3105599_L1.htm,http://www3.registraduria.gov.co/elecciones/elecciones2014/presidente/2v/99PR2/DPR3199999_L1.htm,129,129,48039,20970,19573,794,20367,557,46,14358,70.49,5215,25.60
GINEBRA,VALLE,http://www3.registraduria.gov.co/elecciones/elecciones2014/presidente/2v/99PR2/DPR3105899_L1.htm,http://www3.registraduria.gov.co/elecciones/elecciones2014/presidente/2v/99PR2/DPR3199999_L1.htm,43,43,15459,7990,7393,304,7697,264,29,4445,57.74,2948,38.30
GUACARI,VALLE,http://www3.registraduria.gov.co/elecciones/elecciones2014/presidente/2v/99PR2/DPR3106199_L1.htm,http://www3.registraduria.gov.co/elecciones/elecciones2014/presidente/2v/99PR2/DPR3199999_L1.htm,72,72,26635,14099,13346,378,13724,342,33,10762,78.41,2584,18.82
JAMUNDI,VALLE,http://www3.registraduria.gov.co/elecciones/elecciones2014/presidente/2v/99PR2/DPR3106499_L1.htm,http://www3.registraduria.gov.co/elecciones/elecciones2014/presidente/2v/99PR2/DPR3199999_L1.htm,232,232,91151,39457,36921,1468,38389,992,76,26538,69.12,10383,27.04
LA CUMBRE,VALLE,http://www3.registraduria.gov.co/elecciones/elecciones2014/presidente/2v/99PR2/DPR3106799_L1.htm,http://www3.registraduria.gov.co/elecciones/elecciones2014/presidente/2v/99PR2/DPR3199999_L1.htm,35,35,12307,5519,5251,161,5412,81,26,2890,53.39,2361,43.62
LA UNION,VALLE,http://www3.registraduria.gov.co/elecciones/elecciones2014/presidente/2v/99PR2/DPR3107099_L1.htm,http://www3.registraduria.gov.co/elecciones/elecciones2014/presidente/2v/99PR2/DPR3199999_L1.htm,70,70,25329,13052,11967,536,12503,494,55,3336,26.68,8631,69.03
LA VICTORIA,VALLE,http://www3.registraduria.gov.co/elecciones/elecciones2014/presidente/2v/99PR2/DPR3107399_L1.htm,http://www3.registraduria.gov.co/elecciones/elecciones2014/presidente/2v/99PR2/DPR3199999_L1.htm,32,32,11396,5017,4644,197,4841,147,29,2094,43.25,2550,52.67
OBANDO,VALLE,http://www3.registraduria.gov.co/elecciones/elecciones2014/presidente/2v/99PR2/DPR3107699_L1.htm,http://www3.registraduria.gov.co/elecciones/elecciones2014/presidente/2v/99PR2/DPR3199999_L1.htm,33,33,11167,5427,5131,131,5262,137,28,2895,55.01,2236,42.49
PALMIRA,VALLE,http://www3.registraduria.gov.co/elecciones/elecciones2014/presidente/2v/99PR2/DPR3107999_L1.htm,http://www3.registraduria.gov.co/elecciones/elecciones2014/presidente/2v/99PR2/DPR3199999_L1.htm,636,636,243441,108530,100675,4839,105514,2794,222,72527,68.73,28148,26.67
PRADERA,VALLE,http://www3.registraduria.gov.co/elecciones/elecciones2014/presidente/2v/99PR2/DPR3108299_L1.htm,http://www3.registraduria.gov.co/elecciones/elecciones2014/presidente/2v/99PR2/DPR3199999_L1.htm,110,110,38903,18417,17241,599,17840,510,67,12143,68.06,5098,28.57
RESTREPO,VALLE,http://www3.registraduria.gov.co/elecciones/elecciones2014/presidente/2v/99PR2/DPR3108599_L1.htm,http://www3.registraduria.gov.co/elecciones/elecciones2014/presidente/2v/99PR2/DPR3199999_L1.htm,42,42,14205,5663,5291,219,5510,127,26,2948,53.50,2343,42.52
RIOFRIO,VALLE,http://www3.registraduria.gov.co/elecciones/elecciones2014/presidente/2v/99PR2/DPR3108899_L1.htm,http://www3.registraduria.gov.co/elecciones/elecciones2014/presidente/2v/99PR2/DPR3199999_L1.htm,44,44,15959,6979,6428,273,6701,242,36,2882,43.00,3546,52.91
ROLDANILLO,VALLE,http://www3.registraduria.gov.co/elecciones/elecciones2014/presidente/2v/99PR2/DPR3109199_L1.htm,http://www3.registraduria.gov.co/elecciones/elecciones2014/presidente/2v/99PR2/DPR3199999_L1.htm,85,85,27445,13540,12533,527,13060,447,33,5984,45.81,6549,50.14
SAN PEDRO,VALLE,http://www3.registraduria.gov.co/elecciones/elecciones2014/presidente/2v/99PR2/DPR3109499_L1.htm,http://www3.registraduria.gov.co/elecciones/elecciones2014/presidente/2v/99PR2/DPR3199999_L1.htm,47,47,14446,6744,6349,192,6541,182,21,4167,63.70,2182,33.35
SEVILLA,VALLE,http://www3.registraduria.gov.co/elecciones/elecciones2014/presidente/2v/99PR2/DPR3109799_L1.htm,http://www3.registraduria.gov.co/elecciones/elecciones2014/presidente/2v/99PR2/DPR3199999_L1.htm,98,98,36736,15770,14403,676,15079,592,99,6968,46.20,7435,49.30
TORO,VALLE,http://www3.registraduria.gov.co/elecciones/elecciones2014/presidente/2v/99PR2/DPR3110099_L1.htm,http://www3.registraduria.gov.co/elecciones/elecciones2014/presidente/2v/99PR2/DPR3199999_L1.htm,38,38,12336,5401,5047,159,5206,173,22,1728,33.19,3319,63.75
TRUJILLO,VALLE,http://www3.registraduria.gov.co/elecciones/elecciones2014/presidente/2v/99PR2/DPR3110399_L1.htm,http://www3.registraduria.gov.co/elecciones/elecciones2014/presidente/2v/99PR2/DPR3199999_L1.htm,48,48,15397,6691,6245,221,6466,192,33,2069,31.99,4176,64.58
TULUA,VALLE,http://www3.registraduria.gov.co/elecciones/elecciones2014/presidente/2v/99PR2/DPR3110699_L1.htm,http://www3.registraduria.gov.co/elecciones/elecciones2014/presidente/2v/99PR2/DPR3199999_L1.htm,377,377,147339,70879,64543,3572,68115,2613,151,36655,53.81,27888,40.94
ULLOA,VALLE,http://www3.registraduria.gov.co/elecciones/elecciones2014/presidente/2v/99PR2/DPR3110999_L1.htm,http://www3.registraduria.gov.co/elecciones/elecciones2014/presidente/2v/99PR2/DPR3199999_L1.htm,15,15,4658,2389,2240,77,2317,57,15,1110,47.90,1130,48.76
VERSALLES,VALLE,http://www3.registraduria.gov.co/elecciones/elecciones2014/presidente/2v/99PR2/DPR3111299_L1.htm,http://www3.registraduria.gov.co/elecciones/elecciones2014/presidente/2v/99PR2/DPR3199999_L1.htm,31,31,7982,3569,3329,122,3451,101,17,1020,29.55,2309,66.90
VIJES,VALLE,http://www3.registraduria.gov.co/elecciones/elecciones2014/presidente/2v/99PR2/DPR3111599_L1.htm,http://www3.registraduria.gov.co/elecciones/elecciones2014/presidente/2v/99PR2/DPR3199999_L1.htm,30,30,10112,4271,4032,117,4149,110,12,2264,54.56,1768,42.61
YOTOCO,VALLE,http://www3.registraduria.gov.co/elecciones/elecciones2014/presidente/2v/99PR2/DPR3111899_L1.htm,http://www3.registraduria.gov.co/elecciones/elecciones2014/presidente/2v/99PR2/DPR3199999_L1.htm,41,41,13655,6364,5968,205,6173,168,23,3832,62.07,2136,34.60
YUMBO,VALLE,http://www3.registraduria.gov.co/elecciones/elecciones2014/presidente/2v/99PR2/DPR3112199_L1.htm,http://www3.registraduria.gov.co/elecciones/elecciones2014/presidente/2v/99PR2/DPR3199999_L1.htm,241,241,93764,40421,37565,1637,39202,1120,99,28593,72.93,8972,22.88
ZARZAL,VALLE,http://www3.registraduria.gov.co/elecciones/elecciones2014/presidente/2v/99PR2/DPR3112499_L1.htm,http://www3.registraduria.gov.co/elecciones/elecciones2014/presidente/2v/99PR2/DPR3199999_L1.htm,95,95,35812,16491,15497,522,16019,443,29,11560,72.16,3937,24.57
BUENOS AIRES (PACOA),VAUPES,http://www3.registraduria.gov.co/elecciones/elecciones2014/presidente/2v/99PR2/DPR6801399_L1.htm,http://www3.registraduria.gov.co/elecciones/elecciones2014/presidente/2v/99PR2/DPR6899999_L1.htm,4,4,990,102,99,1,100,1,1,77,77.00,22,22.00
CARURU,VAUPES,http://www3.registraduria.gov.co/elecciones/elecciones2014/presidente/2v/99PR2/DPR6800499_L1.htm,http://www3.registraduria.gov.co/elecciones/elecciones2014/presidente/2v/99PR2/DPR6899999_L1.htm,5,5,1631,540,525,4,529,8,3,380,71.83,145,27.41
MITU,VAUPES,http://www3.registraduria.gov.co/elecciones/elecciones2014/presidente/2v/99PR2/DPR6800199_L1.htm,http://www3.registraduria.gov.co/elecciones/elecciones2014/presidente/2v/99PR2/DPR6899999_L1.htm,42,42,14724,4712,4557,83,4640,51,21,3241,69.84,1316,28.36
MORICHAL (PAPUNAGUA),VAUPES,http://www3.registraduria.gov.co/elecciones/elecciones2014/presidente/2v/99PR2/DPR6801099_L1.htm,http://www3.registraduria.gov.co/elecciones/elecciones2014/presidente/2v/99PR2/DPR6899999_L1.htm,1,1,113,21,21,0,21,0,0,20,95.23,1,4.76
TARAIRA,VAUPES,http://www3.registraduria.gov.co/elecciones/elecciones2014/presidente/2v/99PR2/DPR6801799_L1.htm,http://www3.registraduria.gov.co/elecciones/elecciones2014/presidente/2v/99PR2/DPR6899999_L1.htm,4,4,1305,274,266,4,270,3,1,184,68.14,82,30.37
YAVARATE,VAUPES,http://www3.registraduria.gov.co/elecciones/elecciones2014/presidente/2v/99PR2/DPR6802299_L1.htm,http://www3.registraduria.gov.co/elecciones/elecciones2014/presidente/2v/99PR2/DPR6899999_L1.htm,4,4,994,333,330,1,331,1,1,247,74.62,83,25.07
CUMARIBO,VICHADA,http://www3.registraduria.gov.co/elecciones/elecciones2014/presidente/2v/99PR2/DPR7200699_L1.htm,http://www3.registraduria.gov.co/elecciones/elecciones2014/presidente/2v/99PR2/DPR7299999_L1.htm,56,56,18562,3776,3665,50,3715,54,7,2643,71.14,1022,27.51
LA PRIMAVERA,VICHADA,http://www3.registraduria.gov.co/elecciones/elecciones2014/presidente/2v/99PR2/DPR7200899_L1.htm,http://www3.registraduria.gov.co/elecciones/elecciones2014/presidente/2v/99PR2/DPR7299999_L1.htm,22,22,7190,3264,3148,79,3227,29,8,745,23.08,2403,74.46
PUERTO CARREÑO,VICHADA,http://www3.registraduria.gov.co/elecciones/elecciones2014/presidente/2v/99PR2/DPR7200199_L1.htm,http://www3.registraduria.gov.co/elecciones/elecciones2014/presidente/2v/99PR2/DPR7299999_L1.htm,45,45,15621,5751,5454,198,5652,78,21,2648,46.85,2806,49.64
SANTA ROSALIA,VICHADA,http://www3.registraduria.gov.co/elecciones/elecciones2014/presidente/2v/99PR2/DPR7200299_L1.htm,http://www3.registraduria.gov.co/elecciones/elecciones2014/presidente/2v/99PR2/DPR7299999_L1.htm,9,9,2893,1279,1264,8,1272,3,4,416,32.70,848,66.66
AFRICA,CONSULADOS,http://www3.registraduria.gov.co/elecciones/elecciones2014/presidente/2v/99PR2/DPR8811599_L1.htm,http://www3.registraduria.gov.co/elecciones/elecciones2014/presidente/2v/99PR2/DPR8899999_L1.htm,7,7,17,17,15,1,16,0,1,7,43.75,8,50.00
ALEMANIA,CONSULADOS,http://www3.registraduria.gov.co/elecciones/elecciones2014/presidente/2v/99PR2/DPR8812099_L1.htm,http://www3.registraduria.gov.co/elecciones/elecciones2014/presidente/2v/99PR2/DPR8899999_L1.htm,21,21,2852,685,626,55,681,2,2,468,68.72,158,23.20
ANTIGUA Y BARBUDA,CONSULADOS,http://www3.registraduria.gov.co/elecciones/elecciones2014/presidente/2v/99PR2/DPR8812599_L1.htm,http://www3.registraduria.gov.co/elecciones/elecciones2014/presidente/2v/99PR2/DPR8899999_L1.htm,1,1,8,7,6,1,7,0,0,1,14.28,5,71.42
ARGENTINA,CONSULADOS,http://www3.registraduria.gov.co/elecciones/elecciones2014/presidente/2v/99PR2/DPR8815599_L1.htm,http://www3.registraduria.gov.co/elecciones/elecciones2014/presidente/2v/99PR2/DPR8899999_L1.htm,18,18,5771,1741,1577,132,1709,30,2,1145,66.99,432,25.27
ARUBA,CONSULADOS,http://www3.registraduria.gov.co/elecciones/elecciones2014/presidente/2v/99PR2/DPR8816099_L1.htm,http://www3.registraduria.gov.co/elecciones/elecciones2014/presidente/2v/99PR2/DPR8899999_L1.htm,12,12,2881,824,811,11,822,2,0,245,29.80,566,68.85
AUSTRALIA,CONSULADOS,http://www3.registraduria.gov.co/elecciones/elecciones2014/presidente/2v/99PR2/DPR8816599_L1.htm,http://www3.registraduria.gov.co/elecciones/elecciones2014/presidente/2v/99PR2/DPR8899999_L1.htm,22,22,3843,1094,980,111,1091,3,0,582,53.34,398,36.48
AUSTRIA,CONSULADOS,http://www3.registraduria.gov.co/elecciones/elecciones2014/presidente/2v/99PR2/DPR8817099_L1.htm,http://www3.registraduria.gov.co/elecciones/elecciones2014/presidente/2v/99PR2/DPR8899999_L1.htm,9,9,513,187,169,18,187,0,0,121,64.70,48,25.66
BELGICA,CONSULADOS,http://www3.registraduria.gov.co/elecciones/elecciones2014/presidente/2v/99PR2/DPR8819099_L1.htm,http://www3.registraduria.gov.co/elecciones/elecciones2014/presidente/2v/99PR2/DPR8899999_L1.htm,9,9,1402,401,374,23,397,4,0,263,66.24,111,27.95
BOLIVIA,CONSULADOS,http://www3.registraduria.gov.co/elecciones/elecciones2014/presidente/2v/99PR2/DPR8821599_L1.htm,http://www3.registraduria.gov.co/elecciones/elecciones2014/presidente/2v/99PR2/DPR8899999_L1.htm,8,8,695,178,174,2,176,2,0,58,32.95,116,65.90
BRASIL,CONSULADOS,http://www3.registraduria.gov.co/elecciones/elecciones2014/presidente/2v/99PR2/DPR8822099_L1.htm,http://www3.registraduria.gov.co/elecciones/elecciones2014/presidente/2v/99PR2/DPR8899999_L1.htm,31,31,2047,683,653,27,680,3,0,423,62.20,230,33.82
CANADA,CONSULADOS,http://www3.registraduria.gov.co/elecciones/elecciones2014/presidente/2v/99PR2/DPR8825099_L1.htm,http://www3.registraduria.gov.co/elecciones/elecciones2014/presidente/2v/99PR2/DPR8899999_L1.htm,65,65,15466,4478,4246,214,4460,17,1,2038,45.69,2208,49.50
CHILE,CONSULADOS,http://www3.registraduria.gov.co/elecciones/elecciones2014/presidente/2v/99PR2/DPR8830599_L1.htm,http://www3.registraduria.gov.co/elecciones/elecciones2014/presidente/2v/99PR2/DPR8899999_L1.htm,22,22,4304,1207,1133,65,1198,9,0,584,48.74,549,45.82
CHINA REPUBLICA POPULAR,CONSULADOS,http://www3.registraduria.gov.co/elecciones/elecciones2014/presidente/2v/99PR2/DPR8831599_L1.htm,http://www3.registraduria.gov.co/elecciones/elecciones2014/presidente/2v/99PR2/DPR8899999_L1.htm,21,21,415,151,140,10,150,1,0,91,60.66,49,32.66
CHIPRE,CONSULADOS,http://www3.registraduria.gov.co/elecciones/elecciones2014/presidente/2v/99PR2/DPR8832099_L1.htm,http://www3.registraduria.gov.co/elecciones/elecciones2014/presidente/2v/99PR2/DPR8899999_L1.htm,1,1,42,14,14,0,14,0,0,3,21.42,11,78.57
COREA DEL SUR,CONSULADOS,http://www3.registraduria.gov.co/elecciones/elecciones2014/presidente/2v/99PR2/DPR8827599_L1.htm,http://www3.registraduria.gov.co/elecciones/elecciones2014/presidente/2v/99PR2/DPR8899999_L1.htm,7,7,97,26,26,0,26,0,0,20,76.92,6,23.07
COSTA RICA,CONSULADOS,http://www3.registraduria.gov.co/elecciones/elecciones2014/presidente/2v/99PR2/DPR8828599_L1.htm,http://www3.registraduria.gov.co/elecciones/elecciones2014/presidente/2v/99PR2/DPR8899999_L1.htm,21,21,7400,1798,1731,55,1786,12,0,516,28.89,1215,68.02
CUBA,CONSULADOS,http://www3.registraduria.gov.co/elecciones/elecciones2014/presidente/2v/99PR2/DPR8829099_L1.htm,http://www3.registraduria.gov.co/elecciones/elecciones2014/presidente/2v/99PR2/DPR8899999_L1.htm,7,7,198,35,32,2,34,0,1,28,82.35,4,11.76
CURAZAO,CONSULADOS,http://www3.registraduria.gov.co/elecciones/elecciones2014/presidente/2v/99PR2/DPR8814099_L1.htm,http://www3.registraduria.gov.co/elecciones/elecciones2014/presidente/2v/99PR2/DPR8899999_L1.htm,9,9,1286,276,261,13,274,2,0,94,34.30,167,60.94
DINAMARCA,CONSULADOS,http://www3.registraduria.gov.co/elecciones/elecciones2014/presidente/2v/99PR2/DPR8832599_L1.htm,http://www3.registraduria.gov.co/elecciones/elecciones2014/presidente/2v/99PR2/DPR8899999_L1.htm,1,1,58,26,25,1,26,0,0,13,50.00,12,46.15
ECUADOR,CONSULADOS,http://www3.registraduria.gov.co/elecciones/elecciones2014/presidente/2v/99PR2/DPR8833099_L1.htm,http://www3.registraduria.gov.co/elecciones/elecciones2014/presidente/2v/99PR2/DPR8899999_L1.htm,81,81,21324,4368,4131,151,4282,74,12,1813,42.34,2318,54.13
EGIPTO,CONSULADOS,http://www3.registraduria.gov.co/elecciones/elecciones2014/presidente/2v/99PR2/DPR8833599_L1.htm,http://www3.registraduria.gov.co/elecciones/elecciones2014/presidente/2v/99PR2/DPR8899999_L1.htm,7,7,95,22,21,1,22,0,0,16,72.72,5,22.72
EL SALVADOR,CONSULADOS,http://www3.registraduria.gov.co/elecciones/elecciones2014/presidente/2v/99PR2/DPR8834099_L1.htm,http://www3.registraduria.gov.co/elecciones/elecciones2014/presidente/2v/99PR2/DPR8899999_L1.htm,7,7,472,185,173,11,184,1,0,74,40.21,99,53.80
EMIRATOS ARABES UNIDOS,CONSULADOS,http://www3.registraduria.gov.co/elecciones/elecciones2014/presidente/2v/99PR2/DPR8835099_L1.htm,http://www3.registraduria.gov.co/elecciones/elecciones2014/presidente/2v/99PR2/DPR8899999_L1.htm,8,8,789,441,400,31,431,10,0,50,11.60,350,81.20
ESPAÑA,CONSULADOS,http://www3.registraduria.gov.co/elecciones/elecciones2014/presidente/2v/99PR2/DPR8835599_L1.htm,http://www3.registraduria.gov.co/elecciones/elecciones2014/presidente/2v/99PR2/DPR8899999_L1.htm,225,225,80641,8605,8070,474,8544,57,4,3607,42.21,4463,52.23
ESTADOS UNIDOS,CONSULADOS,http://www3.registraduria.gov.co/elecciones/elecciones2014/presidente/2v/99PR2/DPR8836099_L1.htm,http://www3.registraduria.gov.co/elecciones/elecciones2014/presidente/2v/99PR2/DPR8899999_L1.htm,497,497,183108,40119,39281,750,40031,69,19,8982,22.43,30299,75.68
FILIPINAS,CONSULADOS,http://www3.registraduria.gov.co/elecciones/elecciones2014/presidente/2v/99PR2/DPR8837099_L1.htm,http://www3.registraduria.gov.co/elecciones/elecciones2014/presidente/2v/99PR2/DPR8899999_L1.htm,1,1,71,21,21,0,21,0,0,10,47.61,11,52.38
FINLANDIA,CONSULADOS,http://www3.registraduria.gov.co/elecciones/elecciones2014/presidente/2v/99PR2/DPR8837599_L1.htm,http://www3.registraduria.gov.co/elecciones/elecciones2014/presidente/2v/99PR2/DPR8899999_L1.htm,7,7,60,36,35,1,36,0,0,24,66.66,11,30.55
FRANCIA,CONSULADOS,http://www3.registraduria.gov.co/elecciones/elecciones2014/presidente/2v/99PR2/DPR8838099_L1.htm,http://www3.registraduria.gov.co/elecciones/elecciones2014/presidente/2v/99PR2/DPR8899999_L1.htm,22,22,6805,1767,1665,88,1753,13,1,1267,72.27,398,22.70
GRECIA,CONSULADOS,http://www3.registraduria.gov.co/elecciones/elecciones2014/presidente/2v/99PR2/DPR8840599_L1.htm,http://www3.registraduria.gov.co/elecciones/elecciones2014/presidente/2v/99PR2/DPR8899999_L1.htm,1,1,49,26,23,3,26,0,0,9,34.61,14,53.84
GUATEMALA,CONSULADOS,http://www3.registraduria.gov.co/elecciones/elecciones2014/presidente/2v/99PR2/DPR8841099_L1.htm,http://www3.registraduria.gov.co/elecciones/elecciones2014/presidente/2v/99PR2/DPR8899999_L1.htm,9,9,706,285,272,13,285,0,0,77,27.01,195,68.42
HOLANDA,CONSULADOS,http://www3.registraduria.gov.co/elecciones/elecciones2014/presidente/2v/99PR2/DPR8843599_L1.htm,http://www3.registraduria.gov.co/elecciones/elecciones2014/presidente/2v/99PR2/DPR8899999_L1.htm,16,16,1537,310,291,19,310,0,0,183,59.03,108,34.83
HONDURAS,CONSULADOS,http://www3.registraduria.gov.co/elecciones/elecciones2014/presidente/2v/99PR2/DPR8844099_L1.htm,http://www3.registraduria.gov.co/elecciones/elecciones2014/presidente/2v/99PR2/DPR8899999_L1.htm,7,7,432,90,85,4,89,1,0,26,29.21,59,66.29
INDIA,CONSULADOS,http://www3.registraduria.gov.co/elecciones/elecciones2014/presidente/2v/99PR2/DPR8845599_L1.htm,http://www3.registraduria.gov.co/elecciones/elecciones2014/presidente/2v/99PR2/DPR8899999_L1.htm,7,7,81,16,16,0,16,0,0,16,100,0,0
INDONESIA,CONSULADOS,http://www3.registraduria.gov.co/elecciones/elecciones2014/presidente/2v/99PR2/DPR8846099_L1.htm,http://www3.registraduria.gov.co/elecciones/elecciones2014/presidente/2v/99PR2/DPR8899999_L1.htm,8,8,193,82,79,3,82,0,0,41,50.00,38,46.34
INGLATERRA,CONSULADOS,http://www3.registraduria.gov.co/elecciones/elecciones2014/presidente/2v/99PR2/DPR8846599_L1.htm,http://www3.registraduria.gov.co/elecciones/elecciones2014/presidente/2v/99PR2/DPR8899999_L1.htm,24,24,8850,1770,1692,75,1767,3,0,952,53.87,740,41.87
IRLANDA,CONSULADOS,http://www3.registraduria.gov.co/elecciones/elecciones2014/presidente/2v/99PR2/DPR8847099_L1.htm,http://www3.registraduria.gov.co/elecciones/elecciones2014/presidente/2v/99PR2/DPR8899999_L1.htm,1,1,98,49,48,1,49,0,0,32,65.30,16,32.65
ISRAEL,CONSULADOS,http://www3.registraduria.gov.co/elecciones/elecciones2014/presidente/2v/99PR2/DPR8849099_L1.htm,http://www3.registraduria.gov.co/elecciones/elecciones2014/presidente/2v/99PR2/DPR8899999_L1.htm,9,9,744,93,88,4,92,1,0,42,45.65,46,50.00
ITALIA,CONSULADOS,http://www3.registraduria.gov.co/elecciones/elecciones2014/presidente/2v/99PR2/DPR8849599_L1.htm,http://www3.registraduria.gov.co/elecciones/elecciones2014/presidente/2v/99PR2/DPR8899999_L1.htm,23,23,4720,627,587,35,622,5,0,330,53.05,257,41.31
JAMAICA,CONSULADOS,http://www3.registraduria.gov.co/elecciones/elecciones2014/presidente/2v/99PR2/DPR8850099_L1.htm,http://www3.registraduria.gov.co/elecciones/elecciones2014/presidente/2v/99PR2/DPR8899999_L1.htm,8,8,287,58,49,9,58,0,0,24,41.37,25,43.10
JAPON,CONSULADOS,http://www3.registraduria.gov.co/elecciones/elecciones2014/presidente/2v/99PR2/DPR8850599_L1.htm,http://www3.registraduria.gov.co/elecciones/elecciones2014/presidente/2v/99PR2/DPR8899999_L1.htm,10,10,776,104,92,12,104,0,0,43,41.34,49,47.11
KENIA,CONSULADOS,http://www3.registraduria.gov.co/elecciones/elecciones2014/presidente/2v/99PR2/DPR8851599_L1.htm,http://www3.registraduria.gov.co/elecciones/elecciones2014/presidente/2v/99PR2/DPR8899999_L1.htm,7,7,62,20,18,2,20,0,0,13,65.00,5,25.00
LIBANO,CONSULADOS,http://www3.registraduria.gov.co/elecciones/elecciones2014/presidente/2v/99PR2/DPR8853599_L1.htm,http://www3.registraduria.gov.co/elecciones/elecciones2014/presidente/2v/99PR2/DPR8899999_L1.htm,8,8,653,96,95,1,96,0,0,64,66.66,31,32.29
MALASIA,CONSULADOS,http://www3.registraduria.gov.co/elecciones/elecciones2014/presidente/2v/99PR2/DPR8856099_L1.htm,http://www3.registraduria.gov.co/elecciones/elecciones2014/presidente/2v/99PR2/DPR8899999_L1.htm,7,7,105,45,41,4,45,0,0,21,46.66,20,44.44
MARRUECOS,CONSULADOS,http://www3.registraduria.gov.co/elecciones/elecciones2014/presidente/2v/99PR2/DPR8858099_L1.htm,http://www3.registraduria.gov.co/elecciones/elecciones2014/presidente/2v/99PR2/DPR8899999_L1.htm,7,7,16,18,18,0,18,0,0,10,55.55,8,44.44
MEXICO,CONSULADOS,http://www3.registraduria.gov.co/elecciones/elecciones2014/presidente/2v/99PR2/DPR8859099_L1.htm,http://www3.registraduria.gov.co/elecciones/elecciones2014/presidente/2v/99PR2/DPR8899999_L1.htm,16,16,4129,1307,1278,25,1303,4,0,647,49.65,631,48.42
NICARAGUA,CONSULADOS,http://www3.registraduria.gov.co/elecciones/elecciones2014/presidente/2v/99PR2/DPR8862099_L1.htm,http://www3.registraduria.gov.co/elecciones/elecciones2014/presidente/2v/99PR2/DPR8899999_L1.htm,7,7,214,72,71,1,72,0,0,40,55.55,31,43.05
NORUEGA,CONSULADOS,http://www3.registraduria.gov.co/elecciones/elecciones2014/presidente/2v/99PR2/DPR8863599_L1.htm,http://www3.registraduria.gov.co/elecciones/elecciones2014/presidente/2v/99PR2/DPR8899999_L1.htm,7,7,105,43,40,3,43,0,0,25,58.13,15,34.88
NUEVA ZELANDIA,CONSULADOS,http://www3.registraduria.gov.co/elecciones/elecciones2014/presidente/2v/99PR2/DPR8862599_L1.htm,http://www3.registraduria.gov.co/elecciones/elecciones2014/presidente/2v/99PR2/DPR8899999_L1.htm,7,7,185,106,94,12,106,0,0,62,58.49,32,30.18
PANAMA,CONSULADOS,http://www3.registraduria.gov.co/elecciones/elecciones2014/presidente/2v/99PR2/DPR8865599_L1.htm,http://www3.registraduria.gov.co/elecciones/elecciones2014/presidente/2v/99PR2/DPR8899999_L1.htm,42,42,10473,1961,1894,63,1957,4,0,571,29.17,1323,67.60
PARAGUAY,CONSULADOS,http://www3.registraduria.gov.co/elecciones/elecciones2014/presidente/2v/99PR2/DPR8866599_L1.htm,http://www3.registraduria.gov.co/elecciones/elecciones2014/presidente/2v/99PR2/DPR8899999_L1.htm,7,7,258,76,74,1,75,1,0,20,26.66,54,72.00
PERU,CONSULADOS,http://www3.registraduria.gov.co/elecciones/elecciones2014/presidente/2v/99PR2/DPR8867099_L1.htm,http://www3.registraduria.gov.co/elecciones/elecciones2014/presidente/2v/99PR2/DPR8899999_L1.htm,19,19,2721,930,877,50,927,3,0,367,39.59,510,55.01
POLONIA,CONSULADOS,http://www3.registraduria.gov.co/elecciones/elecciones2014/presidente/2v/99PR2/DPR8867599_L1.htm,http://www3.registraduria.gov.co/elecciones/elecciones2014/presidente/2v/99PR2/DPR8899999_L1.htm,7,7,108,40,37,3,40,0,0,18,45.00,19,47.50
PORTUGAL,CONSULADOS,http://www3.registraduria.gov.co/elecciones/elecciones2014/presidente/2v/99PR2/DPR8868099_L1.htm,http://www3.registraduria.gov.co/elecciones/elecciones2014/presidente/2v/99PR2/DPR8899999_L1.htm,8,8,332,99,92,7,99,0,0,67,67.67,25,25.25
PUERTO RICO,CONSULADOS,http://www3.registraduria.gov.co/elecciones/elecciones2014/presidente/2v/99PR2/DPR8868399_L1.htm,http://www3.registraduria.gov.co/elecciones/elecciones2014/presidente/2v/99PR2/DPR8899999_L1.htm,11,11,1196,336,328,6,334,2,0,106,31.73,222,66.46
REPUBLICA DOMINICANA,CONSULADOS,http://www3.registraduria.gov.co/elecciones/elecciones2014/presidente/2v/99PR2/DPR8868599_L1.htm,http://www3.registraduria.gov.co/elecciones/elecciones2014/presidente/2v/99PR2/DPR8899999_L1.htm,10,10,1710,477,460,17,477,0,0,163,34.17,297,62.26
RUSIA,CONSULADOS,http://www3.registraduria.gov.co/elecciones/elecciones2014/presidente/2v/99PR2/DPR8870099_L1.htm,http://www3.registraduria.gov.co/elecciones/elecciones2014/presidente/2v/99PR2/DPR8899999_L1.htm,7,7,246,61,57,4,61,0,0,46,75.40,11,18.03
SUDAFRICA,CONSULADOS,http://www3.registraduria.gov.co/elecciones/elecciones2014/presidente/2v/99PR2/DPR8874599_L1.htm,http://www3.registraduria.gov.co/elecciones/elecciones2014/presidente/2v/99PR2/DPR8899999_L1.htm,8,8,186,67,59,8,67,0,0,25,37.31,34,50.74
SUECIA,CONSULADOS,http://www3.registraduria.gov.co/elecciones/elecciones2014/presidente/2v/99PR2/DPR8875599_L1.htm,http://www3.registraduria.gov.co/elecciones/elecciones2014/presidente/2v/99PR2/DPR8899999_L1.htm,9,9,1075,262,251,9,260,2,0,177,68.07,74,28.46
SUIZA,CONSULADOS,http://www3.registraduria.gov.co/elecciones/elecciones2014/presidente/2v/99PR2/DPR8876099_L1.htm,http://www3.registraduria.gov.co/elecciones/elecciones2014/presidente/2v/99PR2/DPR8899999_L1.htm,13,13,2486,594,569,23,592,2,0,356,60.13,213,35.97
TAILANDIA,CONSULADOS,http://www3.registraduria.gov.co/elecciones/elecciones2014/presidente/2v/99PR2/DPR8876599_L1.htm,http://www3.registraduria.gov.co/elecciones/elecciones2014/presidente/2v/99PR2/DPR8899999_L1.htm,7,7,52,31,29,2,31,0,0,21,67.74,8,25.80
TRINIDAD Y TOBAGO,CONSULADOS,http://www3.registraduria.gov.co/elecciones/elecciones2014/presidente/2v/99PR2/DPR8878599_L1.htm,http://www3.registraduria.gov.co/elecciones/elecciones2014/presidente/2v/99PR2/DPR8899999_L1.htm,7,7,103,59,58,1,59,0,0,31,52.54,27,45.76
TURQUIA,CONSULADOS,http://www3.registraduria.gov.co/elecciones/elecciones2014/presidente/2v/99PR2/DPR8877099_L1.htm,http://www3.registraduria.gov.co/elecciones/elecciones2014/presidente/2v/99PR2/DPR8899999_L1.htm,8,8,72,31,30,1,31,0,0,11,35.48,19,61.29
URUGUAY,CONSULADOS,http://www3.registraduria.gov.co/elecciones/elecciones2014/presidente/2v/99PR2/DPR8880599_L1.htm,http://www3.registraduria.gov.co/elecciones/elecciones2014/presidente/2v/99PR2/DPR8899999_L1.htm,7,7,388,145,133,9,142,3,0,83,58.45,50,35.21
VENEZUELA,CONSULADOS,http://www3.registraduria.gov.co/elecciones/elecciones2014/presidente/2v/99PR2/DPR8881599_L1.htm,http://www3.registraduria.gov.co/elecciones/elecciones2014/presidente/2v/99PR2/DPR8899999_L1.htm,384,384,171944,31504,31042,173,31215,235,54,16608,53.20,14434,46.24
